a	un, uno, una
a	uno, una, un
a	un,uno,una,un'
aardvark	oritteropo
aardvarks	oritteropi
ab	da[Preposition]
aback	 di dietro
aback	essere sorpreso/essere preso alla sprovvista
abacterial	abatterico
abacus	abaco
abacuses	abachi
abacuses	abaci
abacuses	abbaco
abaft	posteriore (adj) dietro (adv)
abalone	abalone
abalones	abaloni
abandon	abbandonare (v.t.)
abandon	abbandono
abandon	abbandono(n.)
abandon	lasciare
abandoned	abbandonato m. /abbandonata f.
abandoned	depravato /a
abandonee	diserziente
abandoner	disertore
abandoning	abbandonando
abandonment	abbandono
abandonments	abbandoni
abandons	abbandoni
abase	degradare
abased	degradato
abasement	degradazione
abasements	degradazioni
abaser	degradante
abases	degrada
abash	confondere
abash	sconcertare
abashed	confuso
abashed	sconcertato
abashed	imbarazzato
abashes	confusi
abashing	confondente
abashing	sconcertante
abashment	confusione
abashment	sconcerto
abasing	degradante
abate	porre fine a
abate	ridurre
abate	ridurre, diminuire
abated	ridotto
abated	diminuito
abatement	abolizione
abatement	riduzione
abatements	riduzioni
abater	riducente
abates	riduzioni
abating	riducente
abatis	barricata
abatises	barricate
abattoir	macello
abattoir	mattatoio
abaxial	fuori asse
abbacy	abbazia
abbacy	funzioni dell'abate
abbas	abate
abbe	abate
abberations	aberrazioni
abberrations	aberrazioni
abbey	abbazia
abbey	badia
abbeys	abbazie
abbeys	badie
abbot	abate
abbots	abati
abbreviate	abbreviare
abbreviated	abbreviato m. abbreviata f.
abbreviates	abbrevia
abbreviating	abbreviando
abbreviation	abbreviazione
abbreviations	abbreviazioni
abbreviator	abbreviatore
abdicable	abdicabile
abdicate	abdicare
abdicated	abdicato
abdication	abdicazione
abdicator	abdicatore
abdomen	addome
abdomens	addomi
abdominal	addominale
abdominally	addominalmente
abduce	addurre
abduced	addotto
abducens	adducente
abducent	abduttore
abducentes	adducenti
abducing	adducente
abduct	sequestrare
abduct	rapire
abducted	sequestrato
abducted	rapito/a/i/e
abducting	asportando
abduction	sequestro
abductions	sequestri
abductor	sequestratore
abductor	rapitore
abductors	adduttori
abductors	rapitori
abducts	adduce
abducts	rapisce
abducts	rapisce
abeam	per traverso
abecedarian	abbecedario
abed	a letto
aberrance	aberranza
aberrancy	aberrazione
aberrant	aberrante
aberrantly	anormalmente
aberrate	aberrare
aberrated	deviato
aberration	aberrazione
aberrational	aberrazionale
aberrations	aberrazioni
abet	favoreggiare
abetment	favoreggiamento
abets	favoreggia
abetted	rendutosi complice
abetted	avere favoreggiato
abetter	favoreggiatore
abetting	rendersi complice
abetting	favoreggiando
abettor	complice
abettor	favoreggiatore
abeyance	sospensione temporanea
abeyant	giacente, sospendente
abhor	detestare 
abhor	aborrire
abhorred	aborrito
abhorred	avere aborrito
abhorrence	avversione
abhorrent	avverso
abhorrent	detestabile
abhorrently	odiosamente
abhorrently	detestabilmente
abhorrer	colui che aborrisce
abhorring	aborrendo
abhors	aborrisce
abidance	osservanza
abide	restare
abide	tenere fede a 
abide	attenersi a, rimanere fidele a
abided	attenuto
abided	rimasto fidele a
abider	colui che persevera
abides	si attiene
abides	rimane fidele a
abiding	persistente
abidingly	pertinacemente
abilities	abilita'
ability	abilita' 
abiogenesis	abiogenesi
abiogenetic	abiogenetico
abiogenetical	abiogenetico
abiogenetically	abiogeneticamente
abiogenist	abiogenetista
abiological	abiologico
abiologically	abiologicamente
abiotic	abiotico
abiotically	abioticamente
abject	spregevole
abjection	abiezione
abjections	abioezioni
abjectly	in modo abietto
abjectness	abiettitudine
abjuration	abiura
abjure	abiurare
abjured	abiurato
abjurer	abiuratore
abjures	abiura
abjuring	abiurando
ablate	asportare
ablated	asportato
ablates	asporta
ablating	asportando
ablation	ablazione
ablative	ablativo
ablatively	ablativamente
ablaut	armonia vocalica
ablaut	apofonia
ablaze	splendente
ablaze	in fiame
able	abile
able	capace
able	sperto
abler	piu' abile
ablest	il piu' abile
abloom	in fiore
abluted	lavatosi
ablution	abluzione
ablutionary	addetto all'abluzione
ablutions	abluzioni 
ably	abilmente
abnegate	negarsi
abnegates	abnega
abnegation	abnegazione
abnegator	abnegatore
abnormal	anormale
abnormalities	anomalie
abnormality	anomalia
abnormalize	annormalizzare
abnormalizes	annormalizza
abnormally	in modo normale
abnormally	in momo anormale
abnormally	in modo anormale
aboard	a bordo
abode	residenza
abode	abitazione, dimora
abodes	residenze
abodes	abitazioni, dimore
aboil	bollente
abolish	abolire
abolishable	distruggibile
abolished	abolito
abolisher	abolitore
abolishers	abolizionisti
abolishers	abolitori
abolishes	distruggere
abolishes	abolisce
abolishing	distruggendo
abolishment	abolizione
abolition	abolizione
abolitionary	abolizionario
abolitionism	abolizionismo
abolitionist	abolizionista
abolitionists	abolizionisti
abolitionize	fare abolire
abolitionizes	fa abolire
abomasal	abomasale
abominable	abominevole
abominably	abominevolmente
abominate	abominare
abomination	abominazione
abominations	abominazioni
abominator	colui che abomina
abominators	coloro che abominano
aboral	aborale
aborally	aboralmente
aboriginal	aborigeno
aboriginally	originariamente
aborigine	aborigeno
aborigines	aborigeni
abort	abortire
aborted	abortito
aborter	abortista
abortifacient	abortivo
aborting	abortendo
abortion	aborto
abortionist	abortista
abortionists	abortisti
abortions	aborti
abortive	abortivo
abortively	abortivamente
abortiveness	insuccesso
aborts	aborti
abound	abbondare
abounded	abbondato
abounding	abbondando
abounds	abbondanda
about	circa
above	sopra
aboveboard	leale
aboveground	in superficie
abovementioned	sudetto
abracadabra	abracadabra
abradant	abrasivo
abrade	raschiare
abraded	raschiato
abrades	irrita
abrading	irritante
abrasion	abrasione
abrasions	abrasioni
abrasive	abrasivo
abrasively	abrasivo
abrasiveness	abrasività
abrasives	abrasivi
abreaction	abreazione
abreast	fianco a fianco
abridge	abbreviare
abridged	abbreviato
abridgement	riassunto
abridges	accorcia
abridging	limitante
abridgment	edizione ridotta
abroach	forato
abroad	all'estero
abrogate	abrogare
abrogated	abrogato
abrogates	abrogati
abrogating	abrogando
abrogation	abrogazione
abrupt	improvviso
abruption	improvviso distacco
abruptly	improvvisamente
abruptness	precipitazione
abscess	ascesso
abscesses	ascessi
abscise	ascissa
abscised	ascisso
abscissa	ascissa
abscissae	ascissa
abscissas	ascissa
abscission	recissioe
abscond	scappare
absconded	scappato
absconder	latitante
absconding	in fuga
absconds	fugge
absence	assenza
absences	assenze
absent	assente
absented	assentato
absentee	assente
absenteeism	assenteismo
absentees	assenti
absentia	absence, vacancy
absenting	assentandosi
absently	distrattamente
absentminded	distratto
absentmindedly	sovrappensiero
absentmindedness	distrazione
absents	assenti
absinth	assenzio
absinthe	assenzio
absolute	assoluto
absolutely	assolutamemte
absoluteness	assolutezza
absolutes	assoluti
absolution	assoluzione
absolutism	assolutismo
absolutist	assoltista
absolutistic	assolutistico
absolve	assolvere
absolved	assolto
absolving	assolvente
absorb	assorbire
absorbability	capacita' di venire assorbito
absorbable	assorbibile
absorbance	assorbanza
absorbancy	assorbanza
absorbant	assorbente
absorbed	assorbito
absorbency	assorbenza
absorbent	assorbente
absorber	chi assorbe
absorbing	assorbente, assorbendo
absorbs	assorbe (he, she,it) present tense
absorbtions	assorbimenti
absorption	assorbimento
absorptive	assorbente
abstain	astenersi
abstained	astenuto
abstainer	chi si astiene
abstemious	astemio
abstention	astensione
abstentions	astensioni
abstinence	astinenza
abstinent	astinente
abstract	estrarre
abstract	v: astrarre n,adj: astratto
abstracted	distratto
abstractedness	astrattezza
abstraction	estrazione
abstractionism	asrattismo
abstractionist	astrattista
abstractionists	astrattisti
abstractions	estrazioni
abstruse	astruso
abstruseness	astrusita'
absurd	assurdo
absurdities	assurdita\
absurdity	assurdita'
absurdly	assurdamente
absurdness	assurdita\
abundance	abbondanza
abundant	abbondante
abundantly	abbondantemente
abusable	abusabile
abuse	abusare
abused	abusato
abuses	abusi
abusing	abusando
abusive	offensivo
abusively	abusivamente
abusiveness	illegalita'
abut	fare capo a
abutment	appoggio
abutments	appoggi
abysmal	abissale
abyss	abisso
abyssal	abissale
abysses	abissi
acacia	acacia
academia	accademia
academic	accademico
academical	accademico
academically	accademicamente
academician	accademico
academicism	accademicismo
academies	accademie
academy	accademia
acanthus	acanto
accede	accedere
acceded	consentito
accelerando	accelerando
accelerate	accelerare
accelerated	accelerato
accelerates	accelera (3rd person-simple tense)
accelerating	accelerando
acceleratingly	accelerando
acceleration	accelerazione
accelerations	accelerazioni
accelerative	accelerativo
accelerator	acceleratore
accelerators	acceleratori
accelerometer	accelerometro
accelerometers	accelerometro
accent	accento
accented	accentato
accents	accenti
accentual	accentuativa
accentuate	accentuare
accentuated	accentuato
accentuation	accentuazione
accept	accettare
acceptability	accettabilita/
acceptable	accettabile
acceptableness	accettabilita/
acceptance	accettazione
acceptances	accettazioni
acceptation	accettazione
accepted	accettato
acceptor	accettante
acceptors	accettanti
access	accesso
accessary	accessorio
accessibility	accessibilita/
accessible	accessibile
accession	entrata
accessions	entrate
accessories	accessori
accessors	accessori
accessory	accessori
acciaccatura	acciaccatura
accidence	morfologia
accident	incidente
accidental	accidentale
accidentally	accidentalmente
accipiter	falco
acclaim	acclamar
acclaimed	acclamato
acclamation	acclamazione
acclimate	acclimatare
acclimated	acclimatato
acclimatization	acclimazione
acclimatize	acclimare
acclimatized	acclimatizzato
acclivity	pendio
accolade	accollata
accommodate	alloggiare
accommodated	alloggiato
accommodation	accomodamento/alloggio
accommodative	accomodante
accompanied	accompagnato
accompaniment	accompagnamento
accompanist	accompagnatore
accompanists	accompagnatori
accompany	accompagnare
accompanyist	accompagnatore
accompanyists	accompagnatori
accomplice	complice
accomplices	complici
accomplish	compiere
accomplished	compiuto
accomplishment	compimento
accomplishments	compimenti
accord	accordare
accordance	concordanza
accordances	concordanze
accordant	conforme
accorded	accordato
according	secondo che
accordingly	in conformita/
accordion	fisarmonica
accost	avvicinare
accosts	approcci
account	conto
accountabilities	responsabilita/
accountability	responsabilita/
accountable	responsabile
accountableness	responsabilita/
accountably	spiegabilmente
accountant	contabile
accountants	contabili
accountantship	lavoro di contabile
accounting	contabilita/
accouter	equipaggiare
accouterments	buffetteria
accredit	accreditare
accreditation	accreditamento
accredited	accreditato
accrete	concrescere
accretion	concrescenza
accrue	risultare
accrued	risultato
accumulate	accumulare
accumulated	accumulato
accumulation	accumulazione
accumulative	accumulativo
accumulator	accumulatore
accumulators	accumulatori
accuracies	accuratezze
accuracy	accuratezza
accurate	accurato
accursed	maledetto
accurst	maledetto
accusal	accusa
accusation	accusa
accusative	accusativo
accuse	accusare
accused	accusato
accuser	accusatore
accustom	abituare
accustomed	abituato
ace	asso
acephalous	acefalo
acerb	acerbo
acerbic	acerbo, acido
acerbity	acerbita/
acervate	acervato
acetate	acetato
acetic	acetico
acetification	acetificazione
acetify	acetificare
acetone	acetone
acetous	acetoso
acetylene	acetilene
ache	dolere
achievable	raggiungibile
achieve	compiere, conseguire
achievement	realizzazione/successo
achievements	risultato
achromatic	acromatico
achromatize	acromatizzare
acid	acido
acidic	acido
acidification	acidificazione
acidify	acidificare
acidimeter	acidimetro
acidimeters	acidimetri
acidity	acidita/
acidly	acidamente
acids	acido
acidulate	acidulare
acidulous	acidulo
acinus	acino
acknowledge	riconoscere
acknowledgement	riconoscimento
acknowledgements	riconoscimenti
acknowledgment	riconoscimento / ricevuta
acme	acme
acne	acne
acock	alla sgherra
acolyte	accolito
acolytes	accoliti
acorn	ghianda
acorns	ghiande
acoustic	acustico
acquaint	informare
acquaintance	conoscenza
acquaintances	conoscenze
acquaintanceship	conoscenza
acquiesce	essere acquiescente
acquiescence	acquiescenza
acquiescent	acquiescente
acquirable	acquistabile
acquire	acquisire
acquired	acquisito
acquirement	acquisizioni
acquisition	acquisizione
acquisitive	desideroso di acquistare
acquit	assolvere
acquittal	assoluzione
acquittals	assoluzioni
acquittance	remissione
acre	acro
acreage	ruperficie in acri 
acrid	acre
acridity	acredine
acrimonious	aspro
acrimony	acrimonia
acrobat	acrobata
acrobatic	acrobatico
acrobatics	acrobazie
acronym	acronimo
across	attraverso
acrostic	acrostico
act	atto
acting	rappresentazione
actinic	attinico
action	azione
actionable	giuridicamente tutelabile
activate	attivare
activated	attivato
active	attivo
activism	attivismo
activist	attivista
activity	attivita'
actor	attore
actors	attori
actress	attrice
actresses	attrici
actual	reale
actuality	realta/
actualization	realizzazione
actualizations	realizzazioni
actualize	concretare, realizzare
actually	realmente
actuarial	attuariale
actuary	attuario
actuate	mettere in azione
actuation	messa in moto
acuity	acutezza
aculeate	aculeato
acumen	acume
acuminate	acuminato
acumination	aguzzamento
acupuncture	agopuntura
acute	acuto
acutely	acutamente
acuteness	acutezza
acyclic	non ciclico
ad	avviso / inserzione
adage	adagio
adagio	adagio
adamant	diamante
adamantine	adamantino
adapt	adattare
adaptability	adattabilita'
adaptable	adattabile
adaptation	adattamento
add	aggiungere
addend	addendo
addenda	aggiunta
adder	vipera 
addict	assuefare
addicted	essere assuefatto
addiction	tossicomania
addition	addizione
additional	aggiuntivo
additions	addizioni
additive	additivo
addle	guasto
address	indirizzo
addressee	destinatario
addresser	mittente
addressers	mittenti
adduce	addurre
adducible	adducibile
adductor	adduttore
adenoid	adenoide
adept	abile
adequacy	adeguatezza
adequate	adeguato
adhere	aderire
adhered	aderito
adherence	aderenza
adherences	aderenze
adherent	aderente
adhesion	adesione
adhesions	adesioni
adhesive	adesivo
adhesives	adesivi
adiabatic	adiabatico
adieu	addio
adieux	ciao, addio
adios	ciao, addio
adipose	adiposo
adiposity	obesita
adjacencies	adiacenze
adjacency	adiacenza
adjacent	adiacente
adjectival	aggettivale
adjective	aggettivo
adjectives	aggettivi
adjoin	essere vicino
adjoining	adiacente
after	dopo
afternoon	pomeriggio
afternoons	pomeriggi
aftershave	dopobarba
aftershock	scossa successiva alla principale
aftershocks	scosse successive alla principale
age	eta'
aim	scopo
aimed	intenzionato
aimless	senza scopo
ain't	non e\
air	aria
airbag	airbag
aircraft	velivolo
aircrafts	velivoli
aircrew	equipaggio
airfreight	carico
airline	compagnia aerea
albedo	albedo
albeit	sebbene[Conjunction]
alcazar	alcazar
alchemic	alchemico
alchemical	alchemico
alchemist	alchimista
alchemistic	alchimistico
alchemistical	alchimistico
alchemy	alchimia
alcohol	alcool
alcoholic	alcolico
alcoholically	alcolicamente
alcoholism	alcolismo
algebra	algebra
algebraic	algebrico
algebraically	algebricamente
algorithms	algoritmi
alibi	alibi
alibis	alibi
alidade	alidada
alien	alieno
alienability	alienabilità
alienable	alienabile
alienage	alienazione
alienate	alienare
alienated	alienato
alienating	alienante
alienation	alienazione
align	allineare
aligned	allineato
alignment	allineamento
alimentary	alimentare
aliphatic	alifatico
alive	vivo
alkaline	alcalino
alkalinity	alcalinità
alkalinization	alcalinizzazione
alkalinize	alcalinizzare
alkaloid	alcaloide
allegoric	allegorico
allegorical	allegorico
allegorically	allegoricamente
allegoricalness	allegoricità
allegretto	allegretto
allegro	allegro
allele	allele
allelic	allelico
allergen	allergene
allergenic	allergenico
allergic	allergico
allergy	allergia
alleviate	alleviare
alleviated	alleviato
alliance	alleanza
allied	alleato
alligator	alligatore
alliterate	allitterare
alliteration	allitterazione
amazing	stupefacente
americium	america
amulet	amuleto
amusement	divertimento
amusing	divertente
an	un, uno,una
anachronisms	anacronismo
anachronistic	anacronistico
analysis	analisi
analyst	analista
analysts	analisti
analyze	analizzare
analyzed	analizzato
analyzer	analizzatore
analyzers	analizzatori
anarchic	anarchico
anarchist	anarchico
anarchy	anarchia
anathema	anatema
anatomical	anatomico
anatomically	anatomico
and	e
apple	mela
appointment	appuntamento
arc	arco
arcade	1 arcata; portico, porticato 2 galleria (con negozi)
arcane	arcano
arch	arco; arcata
arch	1 v.tr congiungere con un arco; costruire ad arco 2 inarcare v.intr inarcarsi
arch	birichino, malizioso, furbetto
archaic	arcaico
archaism	arcaismo
archangel	arcangelo
archbishop	arcivescovo
archbishopric	arcivescovado
archdeacon	arcidiacono
archdeaconate	arcidiaconato
archdiocesan	arcidiocesano
archdiocese	arcidiocesi
archdioceses	arcidiocesi
archducal	arciducale
archduchess	arciduchessa
archduke	arciduca
ass	culo
assemble	assemblare
assembled	assemblato
assembler	assemblatore
assess	valutare
assessed	valutato
assesses	valuta
assessment	valutazione
assessments	valutazioni
assessor	assessore
assessors	assessori
asshole	stronzo
assiduity	assiduità
assiduous	assiduo
assign	assegnare
assist	assistere
assistance	assistenza
assistances	assistenze
assistant	assistente
at	presso[Conjunction]
b	B
babbitt	Babbitt
babble	balbettamento
babble	chiacchiera
babbled	balbettato; cianciato
babblement	balbettamento
babbler	chiacchierone
babbling	chiacchierio
babe	bambola
babe	pupa
babes	bambole
babes	pupe
babies	bambini
baboon	babbuino
baboonish	da babbuino; sciocco
babushka	fazzoletto per la testa
baby	bambino
babyhood	infanzia
babyish	bambinesco
babysit	fare la baby-sitter
babysitter	babysitter
babysitters	bambinaie
babysitting	guardar bambini
baccalaureate	maturità
baccarat	baccara\
baccate	a forma di bacca
bacchanal	baccanale
bacchanalia	baccanali
bacchanalian	baccanale - festa pagana
bacchant	baccante
bacchante	baccante
bacchantes	baccanti
bacchantic	di baccante 
bacchic	bacchico
bacciferous	baccifero
bachelor	scapolo
bachelorhood	celibato
bachelors	scapoli
baci	baci
bacillar	bacillare
bacillary	bacillare
bacilli	bacilli
bacillus	bacillo
bacitracin	bacitracina
back	dietro
back	dorso
back	schiena
backache	mal di schiena
backaches	mali di schiena
backbite	calunniare
backbiter	calunniatore
backboard	parte posteriore
backboard	retro
backbone	colonna vertebrale
backbones	colonne vertebrali
backcountry	terra di confine
backcourt	fondo campo
backcross	incrocio tra un ibrido ed un progenitore
backdrop	fondale
backdrops	fondali; sfondi
backed	appoggiato, sostenuto
backer	panettiere
backer	sostenitore
backers	panettieri
backfield	area di difesa
backfire	ritorno di fiamma
backgammon	backgammon
background	formazione
background	sfondo
backgrounds	sfondi
backhand	rovescio
backhanded	ambiguo
backhandedly	manrovescio, equivocamente
backing	sostegno
backlash	contraccolpo, ripercussione
backless	senza schiena o schienale
backlog	cumulo di lavoro arretrato
backlogs	cumuli di lavoro arretrato
backpack	zaino
backpacks	zaini
backpedal	tornare sui propri passi
backrest	schienale
backscatter	retrodiffondere
backscattered	retrodiffuso
backscattering	radiazione di ritorno
backseat	sedile posteriore
backset	sconfitta; rovescio; vortice
backside	ano
backside	deretano
backslapper	persona che si prende troppa confidenza
backslide	ricadere nell'errore
backslider	apostata
backspace	arretrare
backspaces	tasti di ritorno
backstage	che avviene dietro le quinte
backstairs	scala di servizio
backstay	paterasso
backstitch	punto indietro
backstitched	ricamato a punto indietro
backstitches	punti indietro
backstitching	ricamo a punto indietro
backstroke	rovescio (tennis); nuoto a dorso
backtrack	tornare
backtracked	tornato
backward	indietro
backwardly	tardivamente; all'indietro
backwardness	arretratezza; riluttanza; timidezza; ottusita/
backwards	indietro
backwash	riflusso
backwash	risacca
backwash	sgrassare
backwater	acqua stagnante
backwaters	acque stagnanti
backwood	foresta vergine
backwoods	foreste vergini
backwoodsman	uomo delle foreste, uomo rozzo
backyard	cortile
bacon	lardo
bacteria	batteri
bacterial	batterico
bactericidal	battericida
bactericide	battericida
bacterium	batterio
bad	male
badge	distintivo
badged	segno
badger	tasso
badges	distintivi
badly	malamente
badminton	badminton
badness	cattiveria; malvagita/
baffle	eludere; sconcertare
baffled	sconcertato
baffling	sconcertante
bafflingly	in modo sconcertante
bag	borsa
bagatelle	bagatella
bagatelles	bagatelle
bagful	pieno
baggage	bagaglio
bagman	commesso viaggiatore
bagpipe	cornamusa
bagpiper	suonatore di cornamusa
bagpipes	cornamuse
bags	borse
baguette	baguette
bail	cauzione; garanzia
bailiff	funzionario di tribunale
bairn	bambino
bait	esca
baited	adescato
baits	esche
bake	cuocere
baked	cotto
baker	panettiere
bakeries	panetterie
bakers	panettieri
bakery	panetteria
balalaika	balalaica
balalaikas	balalaiche
balance	equilibrio
balanced	equilibrato
balances	equilibri
balconies	balconi; terrazze
balcony	balcone
bald	calvo
balderdash	ciance; frottole
baldness	calvizie; alopecia
bale	balla di merce
baleful	funesto; maligno
balk	trave
balked	frustrato; privato
ball	ballo; pallone; palla
ballad	ballata; canzone popolare
ballade	ballata; canzone popolare
ballast	zavorra
ballasts	zavorre
ballerina	ballerina
ballerinas	ballerine
ballet	balletto
balletomane	maniaco del balletto
ballets	balletti
ballistic	balistico
ballistically	balisticamente
balloon	pallone; aerostato
balloonist	aeronauta da pallone
balloons	palloni; aerostati
ballot	ballottaggio
ballroom	sala da ballo
ballrooms	sale da ballo
balls	balli
balm	balsamo
balms	balsami
balmy	dolce; fragrante; mite; soave
baloney	mortadella
balsa	balsa
balsam	balsamo - unguento
balsamic	balsamico
balsams	balsami - unguenti
baluster	balaustro
balustrade	balaustrata
balustrades	balaustrate
bamboo	bambù - canna di bambù
bamboos	bambu\
ban	bando; proibizione; censura
banal	banale
banality	banalita'
banally	banalmente
banana	banana
bananas	banane
band	banda
bandage	benda; fasciatura
bandages	bende; fasciature
bandaging	fasciatura
bandaid	cerotto
bandit	bandito
banditry	brigantaggio
bandits	banditi
bandmaster	capobanda
bandoleer	bandoliere
bandoleers	bandolieri
bandolier	bandoliera
bandsman	bandista; musicante
bandstand	palco per banda
bandstands	palchi per banda
bandwagon	carro della banda che precede il corteo
bandwagons	carri della banda che precedono il corteo
bandy	storto; curvo
bane	veleno; flagello; sventura
bang	colpo; scoppio; rumore improvviso
bangle	braccialetto
bangles	braccialetti
bangs	colpi; scoppi
banish	bandire; esiliare; scacciare
banished	bandito; esiliato; scacciato
banishment	bando; esilio
banister	ringhiera
banisters	ringhiere
banjo	banjo
bank	banca; banco
banker	banchiere
bankers	banchieri
banking	bancario
bankrupt	bancarotta
bankruptcies	fallimenti
bankruptcy	fallimento
bankrupted	fallito
bankrupts	bancarotte
banned	bandito; esiliato; scacciato
banner	vessillo; bandiera
banners	vessilli; bandiere
banquet	banchetto; convito
banquets	banchetti; conviti
banshee	fantasma urlante che annuncia la morte
banshees	fantasmi urlanti
bantam	pollo piccolissimo; 
bantamweight	peso gallo
banter	motteggio; canzonatura
bantered	motteggiato; canzonato
baptism	battesimo
baptismal	battesimale
baptisms	battesimi
baptistery	battistero
baptistries	battisteri
baptistry	battistero
baptists	battisti
baptizable	battezzabile
baptize	battezzare
baptized	battezzato
baptizer	battista
bar	barra; ordine degli avvocati
barb	punta; spina; aculeo
barbarian	barbaro
barbarianism	barbarismo
barbarianize	barbarizzare
barbarianizes	barbarismi
barbarians	barbari
barbaric	barbaro
barbarically	barbaramente
barbarism	barbarie
barbarities	barbarie
barbarity	barbarie
barbarization	barbarizzazione
barbarize	barbarizzare
barbarous	barbaro; crudele
barbarously	barbaramente; crudelmente
barbarousness	barbarie
barbecue	barbeque ( mutuated from FRENCH)
barbecued	cotto alla brace
barbed	spinato; uncinato
barber	barbiere
barbers	barbieri (pl.)
barbershop	barbieria
barbiturate	barbiturico
barbiturates	barbiturici
barbwire	filo spinato
bard	bardo
bards	bardi
bare	nudo
bareback	senza sella
barebacked	 al pelo
barefaced	impudente
barefoot	scalzo
bareheaded	a capo scoperto
barfly	ubriacone
bargain	affare
barge	entrare senza chiedere permesso
baritonal	baritonale
baritone	baritono
barium	bario
bark	abbaiare
barkeeper	barista
barleycorn	malto
barmaid	barista
barman	barista
barnacle	cirripede
barnyard	aia
barometer	barometro
barometers	barometri
barometric	barometrico
barometrical	barometrico
barometrically	barometricamente
barometry	barometria
baron	barone
baroness	baronessa
baronet	baronetto
baronial	baronale
barony	baronia
baroque	barocco
barrack	caserma
barrel	botte
barricade	barricata
barricades	barricate
barrier	barriera
bartender	barista
barter	baratto
bartered	barattato
basal	basale
basally	basalmente
basalt	basalto
baseline	linea di fondo
basement	piano interrato
bash	arrossire
bashful	timido
bashfully	timidamente
basic	basico
basically	praticamente
basicity	basicita\
basil	basilico
basilar	basilare
basilisk	basilisco
basin	catino
basket	cesto
basketball	pallacanestro
bastard	bastardo
bastardization	bastardizzazione
bat	pipistrello
bateau	battello
bath	bagno
bathe	bagnare bagnarsi
bathroom	bagno
bathtub	vasca da bagno
battle	battaglia
battlefield	campo di battaglia
battlefields	campi di battaglia
be	essere
beach	spiaggia
beast	bestia
beat	picchiare
beautiful	bel, bella
beauty	bellezza
beaux	fidanzati
became	diventato
because	perché
becomes	diventa
bed	letto
beds	letti
bee	ape
beer	birra
bees	api
beeswax	cera d'api
before	prima
beginner	principiante
belladonna	belladonna
bench	panchina
benches	panchine
binary	binario
bird	uccello
birthday	compleanno
bitch	puttana,mignotta,baldracca
black	nero
blackbird	il merlo
blahs	malcolm
bleat	belare
bludgeon	mazza
bludgeoned	bastonato
boat	la nave
bone	osso
boneless	disossato
bonfire	falo\
bongo	bongo
bonsai	bonsai
book	libro
box	scatola
brand	marca
brave	valoroso
bread	pane
breads	pani
breakfast	prima colazione
breath	fiato
breathe	respirare
breeze	vento ( wind)
bribe	bustarella
bribe	corrompere
briber	corruttore
bribery	corruzione
brick	mattone
bride	fidanzata
bride	sposa
bridegroom	sposo
brides	fidanzate
bridge	ponte
brief	breve
brief	conciso
briefcase	valigetta
brood	covata; rimuginare (verb)
brother	fratello
brotherhood	fratellanza
brotherly	fraternamente
brothers	fratelli
brought	portato
brown	castano
brucellosis	brucellosi
brutal	brutale
brutalities	brutalità (plurale)
brutality	brutalmente
brutalization	brutalizzazione
brutalize	brutalizzare
brutalized	brutalizzato
brutalizing	brutalizzante
brutally	brutalmente
bryophyta	briofita
bryophyte	briofite
bucolic	bucolico
bucolically	bucolicamente
budge	spostarsi, spostare,smuovere (fig.)
budget	bilancio preventivo
budgie	pappagallino
buff	color camoscio; appassionato
buffalo	bufalo, bisonte
buffer	respingente, memoria tampone
buffet	buffet, servizio ristoro ,
buffeted	sferzato (to buffet: sferzare)
bug	insetto, virus, microfono spia( verb): mettere sotto controllo, scocciare
build	edificio
builded	edifficato - costruito -eretto
builder	costruttore
builders	costruttori - edificatori 
building	ufficio
buildings	uffici
builds	edifici - costruzioni
bulldozer	bulldozer - ruspa meccanica
bulletin	bollettino
bulletins	bollettini (plurale)
bundle	Italian translation
bunnies	conigli ( rabbits)
bunny	coniglio ( rabbit)
burglar	ladro
burglars	ladri
but	ma[Conjunction]
c	ci
cab	tassi
cab	taxi
cabal	intrigo
cabala	cabala
cabala	scienza occulta
cabalism	occultismo
cabalist	cabalista
cabalist	occultista
cabalistic	cabalistico
caballero	cavaliere
cabana	capanna
cabanas	capanne
cabaret	caffe/ concert
cabbage	cavolo
cabbages	cavoli
cabbie	vetturino; tassista
cabbies	vatturini; tassisti
cabby	tassista
cabdriver	tassista
cabin	cabina
cabin	rustico
cabinet	armadietto
cabinet	gabinetto
cabinetmaker	ebanista
cabinetmakers	ebanisti
cabinetmaking	ebanisteria
cabinets	armadietti
cabinetwork	ebanisteria
cabins	capanne; baracce
cable	cavo
cabled	cablato
cablegram	cablogramma
cablegrams	cablogrammi
cables	cavi
cableway	funivia
cabling	cablando
cabman	vetturino
caboodle	tutto quanto
caboose	cambusa
cabotage	cabotaggio
cabriole	saltellare, capriola
cabriolet	cabriolet
cabs	taxi
cabstand	posteggio per i taxi
cacao	cacao
cacciatore	Cacciatore is an Italian word meaning Hunter in English
cachalot	capodoglio
cache	cache
cachectic	cachettico
cached	nascosto
cachepot	coprivaso
caches	nascondigli
cachet	sigillo
cachou	caucciu\
cackle	schiamazzo
cackler	chiacchierone
cackles	chiacchiere
cacodemon	spirito maligno
cacographical	cacografico
cacography	cacografia
cacophonist	cacofonista
cacophonously	cacofonicamente
cacophony	cacofonia
cactus	cactus
cactuses	cacti
cad	maleducato
cadastral	catastale
cadastrally	catastalmente
cadastre	catasto
cadaver	cadavere
cadaveric	cadaverico
cadaverine	cadaverina
cadaverous	cadaverico
cadaverously	cadavericamente
caddie	carrello
caddies	carrelli
caddis	larva, esca
caddish	maleducato
caddishly	maleducatamente
caddishness	maleducazione
caddy	portamazze
cadence	cadenza
cadenced	cadenzato
cadences	cadenze
cadencing	cadenzare
cadency	discendenza da un ramo cadetto
cadent	cadente
cadenza	cadenza
cadet	cadetto
cadge	mendicante
cadge	mendicare
cadger	scroccone
cadmium	cadmio
caduceus	caduceo
caducity	caducita\
caducous	caduco
cafe	caffe\
cafes	caffe\
cafeteria	caffetteria
cafeterias	caffetterie
caffeine	caffeina
caffeinic	caffeinico
caftan	caffetano
cage	gabbia
caged	ingabbiato
cages	gabbie
cagey	cauto
cageyness	prudenza
cahier	quaderno
cahoots	combutta
caiman	caimano
cairn	tumulo
cairned	tumulato
cairns	tumuli
caisson	cassettone
caitiff	vile
cajole	lusinga
cajoled	lusingato
cajolement	lusinga
cajoler	lusingare
cajolery	lusinga
cajoles	lusinghe
cajoling	lusingare
cake	torta
caked	incrostato
cakes	dolci
caking	fare dei dolci
calabash	recipiente ricavato da una zucca
calaboose	prigione
calamine	calamina
calamint	calaminta
calamite	vegetale fossile
calamities	calamita\
calamitous	calamitoso
calamity	calamita\
calamus	calamo
calash	calesse
calcaneal	del calcagno
calcaneum	calcagno
calcareous	calcareo
calcic	calcico
calcific	calcificante
calcification	calcificazione
calcified	calcificato
calcifuge	calcifugo
calcifugous	calcifugo
calcify	calcificare
calcimine	calcimmina
calcination	calcinazione
calcined	calcinato
calcinosis	calcinosi
calcite	calcite
calcium	calcio
calculable	calcolabile
calculate	calcolare
calculated	calcolato
calculation	calcolo
calculations	calcoli
calculator	contabile
calculators	contabili
calculi	calcoli
calculous	calcoloso
calculus	calcolo
caldron	calderone
calendar	calendario
calendars	calendari
calender	calandra
calends	calende
calendula	calendula
calf	vitello
calfs	vitelli
calfskin	pelle di vitello
caliber	calibro
calibers	calibri
calibrate	calibrare
calibrated	calibrato
calibration	calibratura
calibrations	calibrature
calibre	calibro
calico	calico\
californium	californio
caliginous	caliginoso
caliper	compasso
calipers	compassi
caliph	califfo
caliphate	califfato
caliphs	califfi
call	appello
calla	calla
callable	esigibile
callback	richiamare
called	richiamato
caller	chiamante
callers	chiamanti
calligraph	calligrafo
calligrapher	calligrafo
calligraphers	calligrafi
calligraphic	calligrafico
calligraphist	calligrafo
calligraphy	calligrafia
calling	chiamata
calliper	compasso
callose	callosio
callosity	callosita\
callous	calloso
callously	induritamente
callow	immaturo
calls	chiamate
callus	callo
calluses	calli
calm	calmo
calmative	calmante
calmed	calmato
calming	calmante
calmly	con calma
calmness	calma
caloric	calorico
calorie	caloria
calories	calorie
calorific	calorifico
calorimeter	calorimetro
calorimeters	calorimetri
calorimetric	calorimetrico
calorimetry	calorimetria
calory	caloria
calotte	calotta
calumniate	calunniare
calumniated	calunniato
calumniation	calunnia
calumniator	calunniatore
calumnious	calunnioso
calumniously	calunniosamente
calumny	calunnia
calves	vitelli
calypso	calipso
calyx	calice
cam	camma
camaraderie	cameratismo
camber	curvatura
cambered	curvato
cambric	percalle
came	andato
camel	cammello
cameleer	cammelliere
camelia	camelia
camellia	camelia
camellias	camelie
camelopard	giraffa
camels	cammelli
cameo	cammeo
cameos	cammei
camera	macchina fotografica
cameralism	cameralismo
cameraman	operatore cinematografico
cameramen	operatori cinematografici
cameras	macchine fotografiche
camisole	corpetto
camomile	camomilla
camorra	camorra
camorrista	camorrista
camouflage	maschera
camouflaged	mascherato
camouflages	maschere
camp	campeggio
campaign	campagna
campaigner	chi conduce una campagna
campaigners	coloro che conducono una campagna
campaigning	fare una campagna
campaigns	campagne
campanile	campanile
campanology	campanologia
campanula	campanula
campanulate	campanulato
camper	campeggiatore
campers	campeggiatori
campesinos	contadini
campground	campeggio
campgrounds	campeggi
camphene	canfene
camphor	canfora
camphorate	canforare
camphoric	canforato
camps	campi
can	brocca
canal	canale
canary	canarino
cancel	cancellare
cancer	cancro
candid	candido -or- franco
candidate	candidato
candidates	candidati
candidly	candidamente 
candle	candela
candlestick	candeliere
candlesticks	candelieri
candor	candore
candy	dolci canditi (plural)
cane	bastone
canine	canino (noun & adjective)
canines	canini
canister	scatola
canker	canchero
cannibal	cannibale
cannon	cannone (in billiards it's carambola)
cannot	non potere
canoe	canoa
canon	canone (relious law)
canopy	baldacchino
cantankerous	bisbetico
canteen	cantina
canter	piccolo galoppo (little gallop)
canvas	canavaccio
canvass	sollecitare (as to canvass votes)
cap	berretto
capable	capace
cape	mantello (as in a cloak or cover)
caper	(those little pickled or salted berries) cappero - singular
capers	capperi
capital	capitale (as in money-masculine) also... capitale (as in city-feminine)
capitulate	capitolare
capon	cappone
capricious	capriccioso
capriciously	capricciamente (I think!)
capsize	capovolgere
capstan	argano (nautical term)
capstans	argani
capsule	capsula
captain	capitano(noun) - capitanare(verb-as to captain a ship)
captains	capitani
captivating	accattivante
car	automobile
carabiniere	carabiniere
caramel	caramello
caravan	caravan
carbonium	carbonio
carbonization	carbonizzazione
carbonize	carbonizzare
care	care of
castle	castello
castles	castelli
castrate	castrare
castrated	castrato
casual	casuale
casually	casualmente
casualness	casualità
cat	gatto
cataclysm	cataclisma
catacomb	catacomba
catafalque	catafalco
catalepsy	catalessi
catalog	catalogo
catalogs	cataloghi
catalogue	catalogare
catalogued	catalogato
catalogues	cataloghi
catalyst	catalizzatore
catalytic	catalitico
catalyze	catalizzare
catalyzer	catalizzatore
catalyzers	catalizzatori
catamaran	catamarano
catapult	catapulta
catapults	catapulte
cataract	cataratta
catarrh	catarro
catastrophe	catastrofe
catastrophe	disastro
catcall	urlo di disapprovazione
catcher	ricevitore
catching	(participio pres.) di afferrare, prendere, sorprendere, attirare
catching	seducente
catchword	chiamata
catchy	attraente
catechism	catechismo
caterer	el abastecedor
cateress	la abastecedora
caterpillar	la oruga
caterpillars	las orugas
cathedral	la catedral
catholic	cato/lico
cattle	ganado
catty	malicioso
caucus	el comite/
cauliflower	la coliflor
cauliflowers	las coliflores
caulk	cianfrinare
chafe	riscaldare(to rub) -also- irritarsi(as to fret)
chaff	lolla; pulla; (joke) burla; (fig.) loppa
chaff	lolla; pulla; (joke) burla; (fig.) loppa
chaffer	burlone
chaffer	burlone
chaffered	burlato
chaffered	burlato
chaffering	burlesco
chaffering	burlesco
chaffing	burlando
chaffing	burlando
chafing	(chafing-dish) scaldavivande
chagrin	catena(noun)
chagrin	cruccio, dispiacere
chagrin	cruccio, dispiacere
chagrined	crucciato
chagrined	crucciato
chagrining	crucciando
chagrining	crucciando
chagrins	crucci
chagrins	crucci
chain	catena(noun) -also- catenare(verb, as to chain up)
chain	catena; (for necklace) catenella
chain	catena; (for necklace) catenella
chained	incatenato
chained	incatenato
chaining	incatenando
chaining	incatenando
chainlike	come una catena
chainlike	come una catena
chains	catene
chains	catene
chair	sedia
chair	sedia; (at a university)cattedra
chair	sedia; (at a university)cattedra
chaired	presieduto
chaired	presieduto
chairing	presiedendo
chairing	presiedendo
chairlady	presidenta
chairman	presidente
chairman	presidente
chairman	presidente
chairmanship	presidenza
chairmanship	presidenza
chairmanships	presidenze
chairmanships	presidenze
chairmen	presidenti(masculine)
chairmen	presidenti
chairmen	presidenti
chairperson	presidente (for both genders)
chairperson	presidente (for both genders)
chairpersons	presidenti (fo both genders)
chairpersons	presidenti (fo both genders)
chairs	sedie
chairs	sedie
chairwoman	presidentessa (f)
chairwoman	presidentessa (f)
chairwomen	presidentesse (f)
chairwomen	presidentesse (f)
chaise	calesse
chaise	sedia (galicized form of chair)
chaise	sedia (galicized form of chair)
chalice	calice
chalice	calice
chalice	calice
chalices	calici
chalices	calici
chalk	gesso(noun) -also- ingessare(verb, as to chalk)
chalk	gesso (noun); marcare/scrivere col gesso (verb)
chalk	gesso (noun); marcare/scrivere col gesso (verb)
chalked	scritto/marcato col gesso
chalked	scritto/marcato col gesso
chalking	scrivendo/marcando col gesso
chalking	scrivendo/marcando col gesso
chalks	gessi
chalks	gessi
chalky	gessoso
chalky	gessoso
challenge	sfida(noun) -also- sfidare(verb, to challenge)
challenge	sfida; (law) ricusazione
challenge	sfida; (law) ricusazione
challenged	sfidato; (law) ricusato
challenged	sfidato; (law) ricusato
challenges	sfide
challenges	sfide
chamber	camera
chamber	camera, stanza; (of a palace) aula; (of a judge) gabinetto
chamber	camera, stanza; (of a palace) aula; (of a judge) gabinetto
chamberlain	ciambellano
chamberlain	ciambellano
chamberlain	ciambellano
chamberlains	ciambellani
chamberlains	ciambellani
chambermaid	cameriera
chambermaid	cameriera
chambermaid	cameriera
chambermaids	cameriere
chambermaids	cameriere
chameleon	camaleonte
chameleon	camaleonte
chameleonic	camaleonico
chameleonic	camaleonico
chamois	camoscio
chamois	camoscio
chamois	camoscio
champ	(n)(slang) campione; (v) masticare rumorosamente
champ	(n)(slang) campione; (v) masticare rumorosamente
champagne	sciampagna
champagne	champagne spumante
champagne	champagne spumante
champion	campione
champion	difendere (verb)
champion	difendere (verb)
championed	difenduto
championed	difenduto
championing	difendendo
championing	difendendo
championize	farsi paladino di
championize	farsi paladino di
champions	campioni
champions	campioni
championship	campionato
championship	campionato
championships	campionati
championships	campionati
champs	(slang)campioni
champs	(slang)campioni
chance	occasione -also- fortuna(both nouns); arrischiare(verb); casuale(adj.)
chance	(adj) casuale, fortuito; (noun) occasione, caso; (verb) succedere
chance	(adj) casuale, fortuito; (noun) occasione, caso; (verb) succedere
chanced	successo
chanced	successo
chanceful	fortuito
chanceful	fortuito
chancel	coro
chancellor	cancelliere
chandelier	candelabro
change	moneta spicciola(noun, as in small money); cambiamento(noun, asin an alteration); cambiare(verb)
changeable	variabile
changeless	immutabile
channel	canale
channeled	incanalato
channels	canali
chant	cantico(noun); cantare(verb)
chaos	caos
chaotic	caotico
chapel	cappella
chaperon	accompagnatrice
chaplain	cappellano
chaplains	cappellani
chaplet	rosario(noun, masculine); ghirlanda(as wreath, feminine)
chapter	capitolo
char	carbonizzare
character	carattere
charcoal	carbone di legna
charge	prezzo(as in price); accusa(as in allegation of crime)
chariot	carro
charitable	caritatevole
charity	carita\
charm	amuleto & fascino(nouns); affascinare & incantare(to tame) are verbs 
charming	affascinante
charmingly	affascinantamente
chart	carta marina
charter	brevetto(noun); noleggiare(verb)
charwoman	donna a giornata
chary	cauto -also- economo
chase	caccia(noun); cacciare(as to chase away) & inseguire(as to pursue), verbs
chasm	abisso
chaste	casto
chastely	castamente
chasten	castigare -also- (to humble)sottomettere
chastise	castigare
chastity	castita\
chat	chiacchera(noun) & chiacchierone(chatterbox, noun); chiacchierare(verb)
cheese	formaggio
chicken	pollastro
chicken	pollo
chickens	polli
chief	capo
child	bambino, fancciullo, figlio, ragazzo, infante
children	ragazzo
chocolate	cioccolata
church	chiesa
churches	chiese
citizen	cittadino
citizeness	cittadina
citrus	agrume
city	citta
cleanser	cleanser
climate	clima
climates	climi
climatic	climatico
climatize	climatizzare
climatologist	climatologo
climatologists	climatologi
climatology	climatologia
climb	arrampicarsi
clinic	clinica
clinical	clinico
c'mon	andiamo
c'mon	forza
c'mon	suvvia!
coach	divano
coadjutor	coadiutore
coadjutrices	coadiutrici
coadjutrix	coadiutrice
coagulant	coagulante
coagulants	coagulanti
coagulate	coagulare
coagulated	coagulato
coagulates	si coagula
coagulating	che si coagula
coagulation	coagulazione
coal	carbone
coalize	coalizzare
cold	freddo
collaborate	collaborare
collar	collare [dog]
collar	colletto [shirt]
collide	collidere
collide	scontrarsi
collision	collisione (f)
colloquial	colloquiale
colloquial	famigliare
colony	colonia
commander	tenente colonnello (military rank)
commandments	comandamenti
commas	virgola
commence	cominciare, iniziare
commencement	inizio
commensurable	commensorabile
communist	communista
comprehensive	esaustivo
compressed	compresso
constipation	stipsi
cookies	biscotti
cooking	cucina, la
courtesan	traviata
cow	mucca, vacca
coward	codardo
cowardice	codardia
cowboy	vaccaro
cowboys	vaccari
coworker	collaboratore
coworkers	collaboratori
cows	mucche, vacche
crazy	scema
cream	crema
cream	crema
creamy	cremosa
cube	cubo
cubic	cubico
cunt	figa
cunt	kevins mouth ... and my home
cup	tazza
cup	coppa
curious	curioso
curiousness	curiosità
cursed	maledetto
cute	carino
d	cardellino
dabbled	immerso, agitato
dahlia	dalia
dairy	caseificio
dais	pedana
daisy	margherita
dam	diga
damaging	Dannegiante
damask	DAMASCO
dame	donna
damn	dannare
damnable	vergognoso
damning	conclusivo
damp	umido
damper	serranda
dampish	umidiccio
dandelions	dente di leone
danger	Pericolo
d'art	d'arte
dab	picchiettare-applicare
dabble	dilettarsi
dabbler	dilettante
dabblers	dilettanti
dabbles	si diletta 
dacha	dacha
dachshund	bassotto
dachshunds	bassotti
dactyl	dito
dactylic	dattilico
dactyls	dita
dad	papà -babbo
daddies	papà -babbi
daddy	papà -babbo
dads	papà -babbi
daedal	dedalo
daemon	demone -spirito
daemons	demoni -spiriti
daffodil	tromboncino -narciso
daffodils	tromboncini -narcisi
daffy	sciocco
daft	scemo - matto
dafter	più scemo -più matto
daftest	il più scemo - il più matto
daftness	scemenza
dagger	pugnale
daggers	pugnali
daguerreotype	dagherrotipo
daguerreotypy	dagherrotipia
daily	giornaliero
daily	giornalmente
daiquiri	daiquiri
dale	valle
dalmatian	dalmata
dalmatians	dalmati
damage	danneggiare
damage	danno
damaged	danneggiato
damages	danni
dammed	dannato, maledetto
damnation	dannazione
damned	dannato
dance	ballare
danced	ballavo ballava
dancer	ballerino
dancers	ballerini
dancing	ballando
dangerous	pericoloso
dangerously	pericolosamente
dangers	pericoli
dare	osare
dark	buio, scuro
darkness	oscurita'
darling	caro, tesoro
dart	freccia, dardo
darts	frecce, dardi
dash	trattino
dashed	tratteggiato
daughter	figlia
daughters	figlie
dawn	alba
day	giorno
daybook	agenda
days	giorni
demote	degradare
demoted	degradato
demoting	degradante
demystified	demistificato
demystify	demistificare
den	tana
denationalization	denazionalizzazione
denationalize	denazionalizzare
denature	denaturare
denatured	denaturato
dendrite	dendrite
design	progettare, progetto
designate	designare
designated	designato
designer	progettista, disegnatore
desirable	desiderabile
desire	desiderio
desired	desiderato
desist	desistere
desk	banco
desk	scrivania
desks	banchi
desolate	desolato
d'etat	di stato
d'etre	d'essere
device	dispositivo
devices	dispositivi
dice	dado
dick	cazzo
dictator	dittatore
difficile	difficult
disgrace	disgrazia
disgraceful	disgraziata
disgusting	fascifo
dish	piatta
dishonest	bugiardo
dog	cane
dogfight	lotta fra cani
dogma	dogma
dogmatic	dogmatico
dogs	cani
doing	facendo
doll	Bambola
dollar	Dollaro
dollars	Dollari
dolls	Bambole
dolphin	Delfino
dolphins	Delfini
donkey	asino
donor	donatore
door	porta
doorbell	campanello
doorjamb	stipite
doorkeeper	uscere
doorknob	maniglia
doorman	uscere
doormat	zerbino
doorpost	stipite
doorstop	fermaporta
doorway	entrata
dope	droga
doped	drogato
dorm	dormitorio
dormant	dormiente
dormitory	dormitorio
dorsal	dorsale
dorsally	dorsalmente
dosage	dosaggio
dose	dose
dot	punto(noun); mettere i punti(verb)
double	doppio(adj & adv); doppio(noun); sosia(noun, as in likeness); raddoppiare(verb)
doubt	dubbio(noun); dubitare(verb)
doubtful	dubbioso
doubtfully	dubbiosamente
douche	doccia
dough	pasta
dove	colomba
dovecot	colombaia
dowager	vedova
down	giu\, abbasso(adv & prep); piumino(noun)
downcast	abbattuto
downfall	caduta & rovina
downhill	in dicesa(adj & adv)
dragon	drago
dragonfly	libellula
dragons	draghi
dream	sogno
dreamer	sognatore
dreaming	sognando
dress	vestito
dressed	indossato - vestito
dressing	vestire - indossare
dressings	condimento
drink	bere
drug	farmaco, medicinale, droga
drugged	drogato
drugs	farmaci, medicinali, droghe
drum	tamburo
drums	tamburi
drunk	ubriaco
duchess	duchessa
duchesses	duchesse
duck	anatra
duke	duca
e	dandaleo
each	ogni, ognuno
eager	desideroso(as in keen); ardente(as in desirous)
eagerness	avidita\ (fem); ardore (masc)
eagle	aquila
eagles	aquile
ear	orecchio
earache	mal d'orecchie
eardrum	timpano
earl	conte
earlobe	lobo
early	Presto
earmuff	Copri orecchie
earn	guadagnare
earned	guadagnato
earnest	serio
earnestly	seriamente
earning	guadagno
earnings	guadagni
earphone	cuffia
earphones	cuffie
earring	orecchino
earrings	orecchini
ears	orecchie
earth	terra
earthenware	ceramica
earthlike	Uguale alla terra
earthliness	Simile alla terra
earthly	terreno; terrestre
earthquake	terremoto
earthquakes	Terremoti
earthshaking	Terra tremante
earthstar	Stella terrestre
earthwork	terrapieno
earwax	Cera nell'orecchio
ease	agio(as in comfort) & sollievo(as in relief)  & facilita\(as in facility) are nouns - alleviare & facilitare are verbs 
easel	cavalletto
easier	Facile
easiest	Facilissimo
easily	facilmente
easiness	Con facilita
east	est
eastbound	Verso est
easter	Pasqua
easterly	di levante
eastern	orientale
easy	facile
eat	mangiare
eatable	Manciabbile
eatable	mangiabile
eatables	Manciabbili
eatables	commestibili
eaten	Manciato
eaten	mangiato
eater	mangiatore
eaters	mangiatori
eating	Manciando
eating	mangiando
eats	mangia
eave	gronda
eaves	gronda
eavesdrop	origliare
eavesdropped	origliato
eavesdropper	ascoltatore di nascosto
eavesdropper	origliatore
eavesdroppers	origliatori
eavesdropping	origliando
eavesdrops	origlia
ebb	riflusso (noun); rifluire(verb)
ebb	ritirarsi
ebbed	ritirato
ebbing	ritirando, rifluendo
ebbs	si ritira, rifluisce
ebony	ebano
ebullience	ebollienza
ebullient	bollente
ebulliently	bollentemente
eccentric	eccentrico
eccentricity	eccentricita'
eccentrics	eccentricita'
ecclesiastic	ecclesiastico
ecclesiastical	ecclesiasticale
ecclesiastically	ecclesiasticalmente
ecclesiasticism	ecclesiasticismo
ecclesiology	ecclesiologia
echo	eco(noun); far eco(verb)
eclipse	eclissi(noun); eclissare(verb)
economize	economizzare
economy	economia
ecstasy	estasi
eddy	turbine; gorgo 
edge	filo(noun -as in knife edge), orlo(noun - as in brink); dar il filo(verb - as sharpen), orlare (verb - as in border) 
edible	commestibile
edify	edificare
edit	pubblicare
edition	edizione
editor	editore
editorial	d'editore
educate	istruire; educare(as to rear a child)
education	educazione
educator	educator
eel	anguilla
efface	cancellare
effect	effecto(noun); effettuare(verb)
effective	effettivo
effectively	effettivamente
effectual	efficace
effeminate	effeminato
effervescent	effervescente
efficacious	efficace
efficiency	efficienza
efficient	efficiente
effort	sforzo
effrontery	sfrontatezza
egg	uovo
eggplant	melenzana
egocentric	egocentrico
egocentrism	egocentrismo
egoism	egoismo
egoist	egoista
eight	otto
elbow	gomito
elegance	eleganza
elegant	elegante
eleven	undici
emergency	emergenza
emotion	emozione
engine	motore
engineer	ingegnere
engineering	ingegneria
engineroom	sala macchina
enginerooms	sala macchine
engines	motori
enlarge	ingrandire
enlargeable	ingrandibile
enlarged	ingrandito
enlargement	ingrandimento
enlargements	ingrandimenti
entropy	entropia
entry	entrata
entry	passaggio
entryway	entrate
environment	ambiente
environmental	ambientale
equipment	apparecchiatura
equipments	apparecchiature
estate	proprieta',
estates	 patrimonio, beni
excursion	gita
f	effe
fable	favola
fabled	fantastico
fabler	favoleggiatore, favolista
fables	fiabe; miti; frottole
fabric	stoffa
fabric	tessuto
fabricant	fabbricante
fabricate	fabbricare
fabricate	falsificare(Verb)
fabricate	inventare
fabricated	fabbricato
fabricating	fabbricando
fabrication	fabbricazione (raro), costruzione
fabrications	fabbricazioni (raro), costruzioni
fabricator	fabbricante (raro), costruttore
fabricators	fabbricanti (raro), costruttori
fabrics	stoffe
fabulist	favolista
fabulous	favoloso
fabulously	favolosamente
fabulousness	favolosità (raro), l'essere favolosi
facade	facciata
facades	facciate
face	faccia
faced	dalla faccia
faceless	senza volto, anonimo
faceplate	piattaforma (del tornio)
facer	schiaffo
facet	faccetta, sfaccettatura, aspetto, lato
faceted	sfaccettato
facetious	faceto, arguto
facetiously	in maiera faceta, arguta
facetiousness	facezia
facial	facciale(Adjective)
facile	facile
facile	abile
facilitate	agevolare, facilitare
facilitated	agevolato
facilitates	facilita
facilitating	facilitante
facilitation	facilitazione
facilitator	facilitatore
facilitators	facilitatori
facility	struttura
facing	che sta di fronte
facsimile	facsimile
fact	fatto
faction	fazione
factious	fazioso
factiousness	faziosità
factitious	fittizio
factitiously	fittiziamente
factitive	casuale
factor	fattore
factorage	provvigione
factorial	fattoriale
factories	fabbriche
factors	fattori
factory	fabbrica
factotum	factotum
facts	fatti
factual	fattuale
facultative	facoltativo
facultatively	facoltativamente
faculties	facolta\
faculty	facolta'
fade	svanire
faded	svanito\a\i\e
fail	fallire/mancare
faith	fede
faithful	fedele
faithfully	fedelmente
falciform	falciforme
falcon	falcone
family	famiglia
fantasy	fantasia
fatal	fatale
fatalism	fatalismo
fatalist	fatalista
father	padre
favor	favore
fear	paura
federal	federale
federalism	federalismo
federalist	federalista
federalists	federalisti
feet	piedi
fermium	fermio
ferocious	feroce
ferociously	ferocemente
fertile	fertile
fertility	fertilita'
fervor	fevore
festival	festivale
fever	febbre
fiasco	fiasco
fiber	fibra
fibrillate	fibrillare
fibrillation	fibrillazione
fictitious	fittizio
fidelity	fedelta'
field	campo
field	settore
fifteen	quindici
fifty	cinquanta
fish	pesce
fisherman	pescatore
fishermen	pescatori
fishing	pesca
fishmonger	pescivendolo
fishmongers	pescivendoli
fishnet	rete da pesca
fishy	sospetto,equivoco
fission	fissione
fist	pugno
fitful	irregolare
fitfully	irregolarmente
fitness	buona forma
fitness	idoneità, bouna forma
fitted	adatto, aderente
fitted	su misura
five	cinque
fix	difficoltà
fix	fissare
fixation	fissazione
fixations	fissazioni
fixative	fissativo
fixing	accessori
fixing	contorno
fizzy	effervescente
flatter	lusingare ( to flatter)
flavor	sapore 
fly	volare
flying	volando
for	per[Preposition]
force	forza
foreigner	straniero
foreigners	stranieri
forename	nome
forever	per sempre
forget	dimenticare
forgive	perdonare
fork	forchetta
fork	biforcazione [road,tree]
free	libero
freedom	liberta'
friend	amici
fuck	fottere
fuck	scopare
fucked	fottuto
fucker	fottitore, scopatore
fuckers	fottuti
fucking	del cazzo
fucks	scopate
fuel	benzina
fuel	carburante
fueling	rifornimento
fugitive	fuggitivo
fulgurate	folgorato
gab	chiachiarare
gabardine	gabardina
gabber	chiacchierone
gabbing	chiacchierando
gabble	borbottio, balbettio
gabbler	chiacchiatore, -trice
gaberdine	gabardine, impermeabile di gabardine
gabfest	chiacchierata
gabfests	chiacchierate
gable	(Arch) timpano
gad	vagare, vagabondare
gadfly	(Entom) tafano, persona assillante
gadget	Regalo
gadgets	Regali
gadolinium	gadolinio
gag	bavaglio, (Chir) apribocca, battuta cominca
gaga	gaga, rimbambito
gage	pegno, garanzia, sfida
gagged	imbavagliato
galactose	galattosio
galaxies	galassie
galaxy	galassia
gale	tempesta,vento da burrasca
galenite	galenite
gallant	coraggioso, valoroso,galante
galleon	galeone
galleons	galeoni
galleries	gallarie
gallery	galleria
gallon	gallone=4.5459631 litres
gallons	galloni
gallop	galoppo
gallows	forca
galore	a profusione,in abbondanza
gals	ragazze
galvanic	galvanico
galvanization	galvanizzazione
galvanize	galvanizzare
galvanized	galvanizzato
gambit	gambetto
gamble	giocare d' azzardo
gambler	giocatore d' azzardo
game	gioco
games	giochi
gantry	cavalletto
gap	divario, apertura, breccia, lacuna, valico
gape	aprirsi, spalancare la bocca, sbadigliare
garage	parcheggiare
garaged	percheggiato
garageman	parchieggiatore
garagemen	parcheggiatori
garages	parcheggi
garb	abito, abbigliamento, foggia del vestire
garbage	spazatura
garbage	spazzatura, ciarpame
garbages	spazature
garden	giardino
gardened	giardino
garlic	aglio
garment	indumento
garments	indumenti
gas	benzina, gas
gaseous	gassato
gasoline	benzina
gate	cancello
gather	radunare
gave	dato
gel	gel
gendarme	gendarme
gendarmerie	gendarmeria
gender	genere
gendered	sessuato
gendering	generando
genders	generi
gene	gene
genealogical	genealogico
genealogically	genealogicamente
genealogies	geneologie
genealogist	geneologista
genealogists	geneologiste
genealogy	geneologia
genera	generi
generable	generabile
general	generale
generale	generale
generalist	generalista
generalists	generalisti
generalities	generalita\
generality	generalita\
generalizable	generalizzabile
generalizables	genericita\
generalization	generalizzazione
generalizational	generalizzazionale
generalizations	generalizzazioni
generalize	generalizzare
generalized	generalizzato
generalizer	generalizzatore
generalizers	generalizzatori
generalizes	generalizza
generalizing	generalizzando
generally	generalmente
generalness	genericita\
generals	generali
generalship	grado di generale
generalships	gradi di generale
generate	generare
generated	generato
generates	genera
generating	generando
generation	generazione
generational	generazionale
generations	generazioni
generative	generativo
generatively	generativamente
generator	generatore
generators	generatori
generatrix	generatrice
generic	generico
genesis	genesi
genius	genio
gentile	gentile
gentiles	gentili
gentle	gentile
gentleman	SIGNORE
geographies	geograpfie
geography	geografia
geometry	geometria
get	andare (with particle)
get	diventare (with adj.)
get	ottenere
get	ottenere, ricevere (with noun)
ghetto	ghetto
ghettoization	ghettizzazione, emarginazione
ghettoize	ghetizzare, emarginare
ghettoized	ghetizzato/a, emarginato/a
ghettoizes	ghetizza, emargina
ghettos	ghetto
ghost	fantasma
ghoul	fantasma
giant	gigante
giants	giganti
gift	regalo
girl	ragazza
girlfriend	fidanzata
girlfriends	fidanzate
girls	ragazze
give	dare
glass	cristallo
glass	vetro
go	andare
goal	meta
goalkeeper	PORTTIERE
goat	capra
goats	capre
god	dio
goddamn	dannato
goddamned	dannato
goddess	dea
goddesses	dee
gods	dei
goes	va
going	andando
gold	oro
golden	di oro
gondola	gondola
gondolas	gondole
gondolier	gondoliere
gondoliers	gondolieri
gone	andato via
good	buono
goodbye	ciao
goodbye	arrivederci
goodness	bonta
goodnight	buona sera
goods	roba
goose	oca
gooseflesh	brivido
gorgeous	bellissimo
gossip	chiacchere
govern	governare
governed	governato
government	governo
governments	governi
gown	vestito
gowns	vestiti
grass	erba
grasshopper	cavalletta
grasshoppers	cavallette
grateful	riconoscente
gratification	gratificazione
gratified	gratificato
gratify	gratificare
gratifying	gratificante
gratitude	gratititudine
grave	tomba
green	verde
greet	salutare
grieving	addolorato, 
grill	griglia, grigliata mista
grim	sinistro,brutto
grimace	smorfia
grime	sudiciume
grin	sorriso smagliante
grind	macinare, arrotare; sgobbare
grip	impugnatura , presa; afferrare
grip	impugnatura, presa; (verb) afferrare
grocer	droghiere
group	gruppo
grudge	rancore (m)
grumble	brontolare
guarantee	garanzia
guarantee	garantire
guest	invitato
guide	guidare
guilty	colpevole
guitar	chitarra
guitarist	chitarrista
gulf	golfo
gullible	credulone
gush	sgorgare
gush	zampillare
guy	ragazzo
guys	ragazzi
gymnasium	palestra
gypsy	zingarello
gyroscope	giroscopio
habilitate	abilitare
habilitated	abilitato
habit	abitudine
habit	abitudine (fem)
habitability	abitabilità
habitable	abitabile
habitant	abitante
habitat	habitat
habitation	abitazione
habitations	abitazioni
habitual	abituale
habitually	abitualmente
habituated	abituato
hack	fare a pezzi
hacker	pirata informatico
hackneyed	trito
hah	ha
hail	grandinata, pioggia (figurato: ad es. "di critiche"), raffica
hailstone	chicco di grandine
hailstorm	grandinata
hair	capelli, peli (pubici etc.)
hairbrush	spazzola 
haircloth	foulard
haircut	taglio di capelli
haircutter	barbiere
hairdresser	parrucchiere
hairless	glabro
hairpin	fermaglio per capelli
hairs	peli
hairy	peloso
halcyon	alcione
half	metà
halfcircle	semicerchio
hammer	martello
hand	dare passare
hand	mano
handbag	borsa
handbag	borsetta
handbags	borse
handbags	borsette
handbook	manuale
handbooks	manuali
handcuffs	manette
handle	manico
handle	maniglia
hands	mani
happy	felice, allegro
hare	lepre
harelip	leporino
have	avere
haven	porto; asilo
haversack	bisaccia; (mil.) zaino
haversacks	bisaccie; (mil) zaine
haves	(gli) abbienti
having	avendo
havoc	rovina
havocked	scompigliato
havocking	rovinando; scompigliando
havocs	rovine
haw	bacca;(in speech) esitazione
hawing	voltando a sinistra
hawk	falco; (coll.) persona rapace
hawked	imbonito; (newspaper) strillato
hawker	merciaiolo ambulante
hawkers	merciaioli ambulanti
hawkish	un tanto rapace (coll.)
hawks	falchi; (coll.) persone rapaci
hawser	cavo; gomena
hawthorn	(bot.) biancospino
hay	feno
hayfield	campo di feno
hayfields	prati seminati a fieno
hayfork	forcone
hayloft	fienile
haymow	fienile
hayrack	rastrelliera
hayride	gita notturna in carro da fieno
hayseed	semente d'erba
hayseeds	sementi d'erba
haystack	meta; pagliaio
haystacks	pagliaio
haywire	(coll.) disordinato; in confusione
hazard	pericolo
hazarded	rischiato
hazarding	pericoloso
hazardize	rischiare
hazardizes	rischia
head	testa
heart	cuore
hearts	cuori
heat	calore
heatable	scaldabile
heated	scaldato
heater	riscaldatore
heaters	caloriferi
heaven	paradiso
heavy	pesante
height	altezza
helium	elio
hello	ciao
help	aiutare
help	aiuto
help	auito
helper	aiutante
helpful	utile
helpfully	utilmente
helpless	impotente
hemacytometer	emocitometro
hematic	ematico
hematite	ematite
hematoma	ematoma
henry	enrico
her	lei[Pronoun]
herb	erbe
heritage	Italian-Spanish-german
hint	consiglio, allusione, a, accennareccenno; alludere (verb)
hinterland	retroterra
hip	anca,fianco
hipbone	bacino
hire	assumere, dare lavoro;  dare a noleggio
hiring	assumendo, dando lavoro
hirsute	irsuto
hirsutism	irsutismo
his	suo[Pronoun]
hiss	fischiare
histaminase	istaminasi
histamine	istamina
histaminergic	istaminergico
histochemic	istochimico
histochemistry	istochimica
hoarse	rauco
hoarsely	raucamente
hoax	scherzo, falso allarme
hoaxer	allarmista
hob	piastra (con fornello)
hobby	passatempo
hobbyhorse	chiodo fisso
hobo	vagabondo
home	casa
homebound	Diretto a casa
homebred	domestico
homebuilder	costruttore
homebuilders	costruttori
homebuilt	Costruito in casa
homecoming	Ritornare a Casa
homeland	La Patria
homeless	senza casa
homeliness	semplicità
homely	alla buona
homemade	fatto in casa
homemake	Fatto a Casa
homemaker	Casalinca
homemaking	Fatto in Casa
homeomorph	omeomorfo
homeomorphism	omeomorfismo
homeomorphisms	omeomorfismi
homeopath	omeopata
homeopathic	omeopatico
homeopathically	omeopaticamente
homeopathies	omeopatie
homeopathy	omeopatia
homeowner	proprietario di casa
homeowners	Il padrone di casa
homeownership	Proprietario
homes	Case
homesick	ammalato di nostalgia
homesickness	nostalgia di casa
homesite	Dimora
homespun	fatto in casa
homework	Compiti
homeworkers	Casalinca
homicide	Omicidio
homicides	Omicidi
horny	calloso
horrible	orribile
horribly	spaventosamente
horrid	orrendo
horrific	raccapricciante
horrified	far inorridire
horror	orrore
horse	cavallo
hot	impetuosa
hound	cane da caccia
hour	ora
hourglass	clessidra
hourly	ogni ora
house	casa
house	casa
houseboat	casa galleggiante
houseboats	case galleggianti
humble	umile, modesto; 
humbled	umiliato
humbleness	umiltà, modestia
humbling	umiliante
humbug	sciocchezze, caramelle alla mena
humdrum	monotono, tedioso
i	io[Pronoun]
iambic	giambico
ibidem	ibidem
ice	ghiaccio
iceberg	iceberg
icebergs	iceberg
icebox	frigo portatile
icon	icona
icosahedron	icosaedro
icy	ghiacciato
idea	idea
idem	idem
idiot	scemo
idiots	scemi
if	se
ill	malato
illiterate	alfabeto
illness	malatia
image	imagine
imagine	imaginare
imbecile	cretino
immediately	subito
important	importante
incense	incense
innocent	innocente, semplice, ingenuo
innocent	innocente
insane	impazzire
issue	rilasciare
issue	uscita
it	esso[Pronoun]
italic	corsivo
itch	prurito
item	articolo
iterations	iterazione
iterative	iterativo
iteratively	iterativamente
itinerant	itinerante
ivory	avorio
jab	colpo; secco; puntura
jabbed	punzecchiare
jabber	cicalare
jabber	borbottare
jack	cricco; martinetto(mechanical)
jack	cric (m.)
jackal	sciacallo
jacket	giacchetta
jackpot	premio
jade	giado(stone)
jade	giada
jaded	spossato
jag	tacca(noun); indentare(verb)
jagged	dentallato
jail	prigione  mandare in prigione
jail	carcere (m.)
jail	incarcerare
jailer	carceriere
jalopy	vecchia carretta
jam	marmellata(noun - as in fruit preserve); ingombro(noun - traffic jam); incastrare(verb); bloccare(verb - to block)
jam	ingorgo (traffic)
jam	guaio (difficulty)
jam	pigiare (cram)
jam	pigiare (cram)
jam	disturbare (broadcast)
jam	disturbare (broadcast)
jam	disturbare (broadcast)
jangle	suono discordante(noun); far rumore discordante(verb)
janitor	custode (caretaker)
janitor	bidello (in school)
jar	vaso(noun); scossa(noun - shock); urtare(verb - as to annoy)
jaundice	itterizia
jaw	mandibola
jay	ghiandaia
jealous	geloso
jealously	gelosamente
jealousy	gelosia
jellyfish	medusa
jeopardize	mettere a repentaglio
jeopardized	messo a repentaglio
jeopardizes	mette a repentaglio
jeopardizing	mettendoa repentaglio
jeopardy	pericolo, rischio
jig	giga(noun); ballare la giga(verb)
jigsaw	sega da traforo; gioco di pazienza
jilt	lasciar in asso; civettare(tease)
jingle	tintinnare
job	occupazione; lavoro; impiego
jobber	cottimista; barattiere
jobbery	baratteria; corruzione
jobbing	cottimo; mediazione; baratto
jobless	disoccupato; senza lavoro
joblessness	disoccupazione
joist	putrella; trave
joke	scherzo
jokingly	scherzosamente
journalist	giornalista
journey	gita
journey	viaggio
k	Lettera non presente nell'alfabeto italiano 
kaftan	caftano
kaiser	imperatore tedesco
kale	verza
kaleidescope	caleidoscopio
kaleidoscope	caleidoscopio
kamikaze	kamikaze
kangaroo	canguro
kangaroos	canguri
kaolin	caolino(miner.)
kaolinite	caolinite
karate	karate
karateist	karateka
karyatid	cariatide
kayak	kayak
kcal	kilocaloria
keel	chiglia
key	chiave
key	tasto
keyboard	tastiera
keyhole	buco della serratura
keynote	tonica
kidney	rene
kindness	gentilezza
king	re
kiss	bacio
kisses	baci
kitchen	cucina
kitchens	cucine
knee	ginocchio
knife	coltello
knight	cavaliere
l	"lire diecimila"
lab	laboratorio
label	etichetta
labelable	casa
labeled	etichettato
labial	labiale
laboratory	laboratorio
lamp	lampada
lamps	lampade
land	atterrare
land	terra
landing	sbarco
landlord	padrone
landowner	proprietario
landscape	paesaggio
landslide	frana
lane	vicolo, viottolo
latter	secondo/ultimo
lattice	reticolo
lattices	reticoli
laugh	ridere
launch	lancio/lanciare
launched	lanciato
lead	condurre
leader	capo
leaf	foglia
leaflet	opuscolo
leaflets	opuscoli
lemon	limone
lemonade	limonata
letter	salita[]
letter	livello[]
liar	bugiardo
liars	bugiardi
liberal	liberale
liberalism	liberalismo
liberalist	liberista
liberalistic	liberalistico
liberality	liberalita\
liberalization	liberalizzazione
liberalize	liberalizzare
liberalized	liberalizzato
liberalizer	liberalizzatore
liberalizers	liberalizzatori
liberalizes	liberalizza
liberalizing	liberalizzando
liberally	liberamente
liberalness	senza liberalita\
liberals	liberali
lift	ascensore
like	vorre
linguistics	linguistica
little	piccolo
lived	 io abitato; abitare 
lizard	lucertola
lizards	lucertolas
loaf	pagnotta
loafing	oziosità
loafs	pagnottas
loan	credito, prestito
loath	contrario
loathe	avere in orrore
loathes	detestato
loathly	disdegnoso
loathsome	laido
lobe	lobulo
lobster	aragosta
love	amore
ma	mamma
ma'am	signora
macabre	macabro
macabrely	macabramente
macadam	asfalto
macadamize	pavimentare in macadam
macadamized	pavimentato in macadam
macadamizes	pavimenta in macadam
macadamizing	pavimentando in macadam
macaque	macaco
macaroni	maccheroni
macaronic	maccheronico
macaronically	maccheronicamente
macaroon	amaretto
mace	mazza
macerate	macerare
macerated	macerato
macerates	macera
macerating	macerando
maceration	macerazione
macerations	macerazioni
maces	mazze
machete	machete
machinate	tramare
machinated	tramato
machinates	trama
machinating	tramando
machination	macchinazione
machinator	macchinatore
machine	macchina
machined	fatto a macchina
machinelike	meccanico
machineries	apparecchiature
machinery	apparecchiatura
machines	macchine
machinist	macchinista
machinists	macchinisti
machinization	meccanizzazione
machinize	meccanizzare
machismo	machismo
macho	macho
mackerel	sgombro
mackerels	sgombri
mackintosh	impermeabile
macro	macro
macroaggregate	macroaggregato
macroaggregated	macroaggregato
macrobiotic	macrobiotico
macrocephalic	macrocefalico
macrocephalous	macrocefalo
macrocephaly	macrocefalia
macrocosm	macrocosmo
macrocosmic	macrocosmico
macrocosmically	in modo macrocosmico
macrocyte	macrocita
macrocytic	macrocitica
macrocytosis	macrocitosi
macrodynamic	macrodinamica
macroeconomic	macroeconomico
macroeconomics	macroeconomia
macroevolution	macroevoluzione
macroevolutionary	macroevolutivo
macrofossil	macrofossile
macrogamete	macrogamete
macroinstruction	macroistruzione
macromolecular	macromolecolare
macromolecule	macromolecola
macromolecules	macromolecole
macron	macron
macronucleus	macronucleo
macronutrient	macronutriente
macropathological	macropatologico
macropathology	macropatologia
macrophage	macrofago
macrophages	macrofagi
macrophagic	macrofagico
macrophyte	macrofita
macrophytic	macrofita
macroprocessor	macroprocessore
macros	macro
macroscale	macroscala
macroscopic	macroscopico
macroscopical	macroscopico
macroscopically	macroscopicamente
macrosimulation	macrosimulazione
macrosocioeconomic	macrosocioeconomico
macrostructural	macrostrutturale
macrostructure	macrostruttura
maculate	maculare
maculated	maculato
maculation	maculazione
macule	ma\cula
mad	arrabiato
mad	pazzo
madam	signora
madams	signore
madcap	scervellato
madden	far impazzire
maddened	esasperato
maddening	esasperante
maddeningly	esasperantemente
maddest	il piú pazzo,il piú matto
made	fatto
mademoiselle	madamigella
mademoiselles	madamigelle
madhouse	manicomio, casa di cura per malati di mente
madly	pazzamente
madman	pazzo
madmen	pazzi
madness	pazzia
madrigal	madrigale
madrigalian	madrigalico
madrigalist	madrigalista
madrigals	madrigali
madwoman	pazza
madwomen	pazze
maelstroms	maelstrom
maestro	maestro
mafioso	mafioso
magazine	rivista
magazines	riviste
magenta	magenta
maggot	larva
maggots	larve
maggoty	verminoso
magi	magi
magic	magia
magical	magico
magically	magicamente
magician	mago
magicians	maghi
magisterial	magistrale
magisterially	magistralmente
magisterium	magistero
magistracy	magistratura
magistral	magistrale
magistrally	magistralmente
magistrate	magistrato
magistrates	magistrati
magistrateship	magistratura
magistrature	magistratura
magma	magma
magmatic	magmatico
magnanimity	magnanimita\
magnanimous	magnanimo
magnanimously	magnanimamente
magnanimousness	magnanimita\
magnate	magnate
magnesia	magnesia
magnesium	magnesio
magnesiums	magnesio
magnet	magnete
magnetic	magnetico
magnetically	magneticamente
magnetism	magnetismo
magnetisms	magnetismo
magnetite	magnetite
magnetizability	magnetizzabilita\
magnetizable	magnetizzabile
magnetization	magnetizzazione
magneto	magnete
magnificent	magnifico
magnificently	magnificamente
maid	cameriera
maid	casalingha
mail	posta
mailbox	cassetta postale
mailman	postino
mailsack	sacco postale
majesty	maesta'
major	maggiore
makeup	trucco
malt	il malto
man	uomo
manganese	manganese
manger	mangiatoia
mangle	tritare
manhood	virilità
mania	mania
maniac	maniaco
manicure	manicure
manifest	manifèsto (adj), manifestare (verb)
manifesto	manifèsto
manifold	moltèplice
manipulate	manipolare
mankind	umanità
manly	virile
manner	manièra
mannerism	manierismo
marksman	tiratore scelto
marksmanship	abilità nel tiro
marksmen	tiratori scelti
masseur	massaggiatore
massive	massiccio
mast	àlbero
master	padrone
masterpiece	capolavoro
mastery	padronanza
masticate	masticare
mathematician	matematico
mathematics	matematica
matrices	matrici
matricide	matricidio
matrimony	matrimonio
matrix	matrice
mattress	materasso
mattresses	materassi
may	potere
maybe	forse
mayhem	danni
mayonnaise	maionese
mayor	sindaco
mayors	sindaci
maze	labirinto
me	me, mi[Pronoun]
meadow	prato
meager	magro, scarso
meal	pasto
meals	pasti
mean	mèdia
meaning	significato
means	mèzzo
meantime	frattèmpo
meanwhile	mentre
measles	morbillo
measurability	misurabilità
measurable	misurabile
measure	misura
measured	misurato
measurement	misuramento
measurements	misurazioni
measuring	misuratore
meat	carne
mechanic	meccàaìnico
mechanical	meccànico
mechanism	meccanismo
mechanize	meccanizzare
medal	medàglia
medical	mèdico
medicate	medicare
medicine	medicina
mediocre	mediòcre
mediocrity	mediocrità
meditate	meditare
meditation	meditazione
medium	mèzzo
metaphysics	metafisica
meteorology	meteorologia
meteors	meteore
meter	metro
meters	metri
methadone	metadone
methane	metano
methanol	metanolo
method	metodo
methodic	metodico
methodical	metodico
methodically	metodicamente
methodists	metodista
methodological	metodologico
methyl	metile
methylene	metilene
microphone	micròfono
midget	nano
midnight	mezzanòtte
midriff	diaframma
migration	migrazione
migratory	migratòrio
mild	mite
mildew	muffa bianca
mildness	mitezza
mile	mìglio
mileage	chilometràggio
milestone	piètra miliare
milk	latte
milky	làtteo
mill	mulino
miller	mugnaio
millesimal	millesimale
millibar	millibar
million	millione
misadventure	disgràzia
misappropriate	appropriare indebitamente
miscellaneous	miscellàneo
mischief	cattivèria
mischievous	cattivo, malizioso
misconstrue	fraintèndere
miscreant	miscredènte
misdemeanor	contravvenzione
missive	lettera, messaggio
missives	lettere, messaggi
mistake	errore
mistreat	maltrattare, bistrattare
mistress	padrona
mistrust	sfidùcia
misty	nebbioso
misunderstand	fraintèndere
misuse	abusare di
mite	pezzetino
mitigate	mitigare
model	modello
modelled	modellato
moderated	moderato
moderately	moderatamente
monday	lunedi
monotone	tono uniforme
monotonous	monòtono
monotony	monotonìa
monoxide	monòssido
monsoon	monsone
monster	mostro
monstrosity	mostruosittà
monstrous	mostruoso
month	mese
monthly	mensile
monument	monumento
monumental	monumentale
mood	stato d'ànimo
moody	triste
moon	luna
moonlight	chiaro di luna
morphine	morfina
mother	madre
motherboard	Piastra Madre
motherboard	scheda madre
motherboards	Piastre madri
motherboards	schede madri
mothers	madri
motion	movimento
motor	motore
motorbike	moto
motorcar	automobile
motorcar	macchina
motorcycle	Motocicletta
motorcycle	moto
motorcycles	Motociclette
motorcycles	moto
motorcyclist	Motociclista
motorized	motorizzato
motors	motori
mount	arrampiccarsi
mountain	Montagna
mountains	Montagne
mouse	topo
mouses	topi
mouth	bocca
mouthful	boccone
move	movere
movie	film
movies	film
mozzarella	mozzarella
much	tanto
mushroom	fungo
music	musica
musical	musicale
musicality	musicalita'
musically	musicalmente
musicologist	musicologo
muskox	bue muschiato
muskoxen	buoi muschiati
mussel	cozza
mussels	cozze
must	dovere
mustache	baffi
mustached	baffuto
mustard	mostarda
mutagenic	mutagenico
mutant	mutante
mutants	mutanti
mutated	mutato
mutation	mutazione
mutations	mutazioni
mute	muto
mutilate	mutilare
mutilated	mutilato
mutilates	mutilati
mutilation	mutilazione
mutilations	mutilazioni
mutilator	mutilatore
my	mio, m ; mia, f
mycobacteria	micobatterio
mycology	micologia
mycoplasma	micoplasma
mycosis	micosi
mycotic	micotico
myeline	mielina
myelinization	mielinizazione
myeloid	mieloide
myocardial	miocardico
myocarditis	miocardite
myocardium	miocardio
myofibril	miofibrilla
myoglobin	mioglobina
myopia	miopia
myopic	miope
myopically	miopicamente
myosin	miosina
myosotis	miosite
myotonia	miotonia
myrrh	mirra
mysteries	misteri
mysterious	misterioso
mystery	mistero
mystic	mistico
mystify	mistificare
myth	mito
mythic	mitico
mythical	mìtico
mythologic	mitologico
mythology	mitologia
mythomania	mitomania
mythomaniac	mitomane
myths	miti
nadir	nadir
nag	pisello
naiad	naiade
nail	chiodo
nail	unghia (finger)
nailed	inchiodato
nailing	inchiodando
nails	chiodi
nails	unghie (fingers)
naive	ingenuo
naively	ingenuamente
naiveness	ingenuita\
naivety	ingenuita\
naked	nudo
nakedly	nudamente
nakedness	nudita\
name	dire
name	nome
nameable	nominabile
named	chiamato
nameless	senza nome
namelessly	anonimamente
namelessness	anonimita\
namely	esplicitamente
names	nomi
namesake	omonimo
nanny	governante
nanogram	nanogrammo
nanograms	nanogrammi
nanometer	nanometro
nanometers	nanometri
nanosecond	nanosecondo
nanoseconds	nanosecondi
nap	pennichella
nape	nuca
naphtha	nafta
napkin	tovagliolo
napkins	tovaglioli
narcissistic	narcisistico
narcissus	narciso
narcist	narcisista
narcosis	narcosi
narcotic	narcotico
narcotics	narcotici
narcotized	narcotizzato
narrate	narrare
narration	narrazione
narrators	narratore
narrow	stretto
narrowed	ristretto
narrowminded	di mente ottusa
narrowness	strettezza
nasal	nasale
nascent	nascente
nasturtium	nasturzio
nasty	sudicio; brutto(as a person)
natant	natante
nation	nazione
national	nazionale
nationalism	nazionalismo
nationalisms	nazionalismi
nationalist	nazionalista
nationalists	nazionalisti
nationality	nazionalita'
nations	nazioni
native	nativo; indigeno(aborigines)
nativity	nativita'
nattier	piu' elegante
nattily	elegantemente
nattiness	eleganza
natty	elegante
natural	naturale
naturalism	naturalismo
naturalist	naturalista
naturalization	naturalizzazione
nature	natura
naught	nulla; niente; zero
naughty	cattivo
nausea	nausea
nauseas	nauseabondo
nautical	nautico
naval	navale
navel	ombelico
navigability	navigabilita'
navigable	navigabile
navigate	navigare
navigation	navigazione
navigator	navigatore
navy	marina; flotta
nay	anzi
near	vicino, prossimo(adjs); avvicinarsi(verb) 
nearly	quasi
nearsighted	miope
neat	accurato(as in accurate); grazioso(as in dainty); ordinato(as in tidy)
neatness	accuratezza; pulizia(as in elegance)
necessarily	necessariamente
necessary	necessario
necessitate	necessitare
necessity	necessita\
neck	collo
necklace	collana
need	abbisognare(verb); bisogno, mancanza(nouns)
needful	necessario(adj & noun)
needfully	necessariamente
needless	inutile
needy	bisognoso
negation	negazione
negative	negativa(noun); negativo(adj)
negatively	negativamente
neglect	negligere
negligence	negligenza
negligent	negligente
negotiate	negoziare
negotiation	negoziazione
neighbor	vicino
neighborhood	vicinanza
neighborly	da buon vicino
neither	ne\[Conjunction]
nephew	nipote
nerve	nervo; coraggio(as in guts or courage)
neuralgia	nevralgia
neuritis	neurite
neuter	neuto(in grammar)
neutral	neutrale(adj. & noun)
never	mai
nevertheless	nonostante, tuttavia
new	nuovo
newly	nuovamente
news	notizie(pl)
newsagent	giornalaio
newspaper	giornale
newspapers	i giornali
next	(Adjectives)vicino, seguente, prossimo, a lato(besides); (Adverb)in seguito
nib	pennino
nibble	rodere; abboccare(fish)
nice	gentile
nicely	gentilmente
nick	tacca
nickel	nickel
nickname	soprannome
nicotine	nicotina
night	notte
nitwit	sciocco
nix	no
no	no
nobility	nobilta\
noble	nobile
nobleman	nobile
nobodies	nessuni
nobody	nessuno
nod	far cenno di testa(verb); cenno di testa(noun)
noise	rumore
noiseless	senza rumore; tranquillo
noiselessly	tranquillamente
noisily	rumorosamente
noisy	rumoroso
nominal	nominale
nominate	nominare
nominee	persona designata
none	nessuno[Pronoun]
nonsense	assurdita\[Pronoun]
nonskid	non sdrucciolevole
nonstop	continuo; diretto(as train or plane flight)
nose	naso
not	non[Preposition]
notebook	quaderno
notebooks	quaderni
nothing	niente
oaf	zoticone
oafish	goffo
oafishly	goffamente
oafishness	buzzurraggine
oafs	zoticoni
oak	quercia
oaken	di quercia
oaks	quercie
oakwood	legno di quercia
oar	remo
oared	dotato di remi
oars	remi
oarsman	rematore
oarsmanship	abilita/ del rematore
oasis	oasi
oat	avena
oatcake	focaccia d'avena
oatcakes	focaccie d'avena
oaten	d'avena
oath	giuramento
oath	imprecazione
oaths	giuramenti
oaths	imprecazioni
oatmeal	farina d'avena
oats	avena
obbligato	obbligato
obduracy	testardaggine
obdurate	testardo
obdurately	caparbiamente
obdurateness	testardaggine
obedience	ubbidienza
obedient	ubbidiente
obediently	ubbidientemente
obelisk	obelisco
obese	obeso
obesity	obesita'
obey	ubbidire
obfuscate	offuscare
obfuscated	offuscato
obfuscater	offuscatore
obfuscates	offusca
obituaries	necrologi
obituary	necrologio
object	obiettivo, scopo
object	oggetto
objection	obiezione
objections	obiezioni
objective	obiettivo
objectives	obiettivi
objector	obiettore
objectors	obiettori
objects	oggetti
objet	obiettare
oblation	oblazione
oblations	oblazioni
obligate	obbligare
obligated	obbligato/a
obligates	obbliga
obligation	obbligo
obligatory	obbligatorioo
oblique	obliquo
obliterate	cancellare
obliterated	cancellato
obliterates	cancella
obliteration	cancellatura
obliterations	cancellature
oblivion	oblio
oblong	oblungo
oblong	rettangolare
oblongated	oblungato
obloquy	diffamazione
obnoxious	sgradevole
obnoxiously	sgradevolmente
obnoxiousness	sgradevolezza
oboe	oboe
oboist	oboista
obscene	osceno
obscenities	oscenita'
obscenity	oscenita'
obscurant	oscurante
obscurantism	oscurantismo
obscurantist	oscurantista
obscuration	oscuramento
obscurations	oscuramenti
obscure	oscuro
obscure	sconosciuto
obscured	offuscato
obscurity	oscurita'
obsequies	esequie
obsequious	ossequioso
observable	osservabile
observable	visibile
observance	osservanza
observances	osservanze
observant	osservante
observation	osservazione
observations	osservazioni
observatories	osservatori
observatory	osservatorio
observe	osservare
observed	osservato
observer	osservatore
observers	osservatori
observes	osserva
observing	osservando
obsess	ossessionare
obsessed	ossesso
obsesses	ossessa
obsession	ossessione
obsessions	ossessioni
obsessive	ossessivo
obsessively	ossessivamente
obstacle	ostacolo
obstacles	ostacoli
obstetric	ostetrico
obstetrical	ostetrico
obstetrician	ostetrico
obstetricians	ostetrici
obstetrics	ostetricia
obstinacy	ostinazione
obstinate	ostinato
obstinately	ostinatamente
obstinateness	ostinatezza
obstruct	ostruire
obstructed	ostruito
obstruction	ostruzione
obstructionism	ostruzionismo
obstructionist	ostruzionista
obstructions	ostruzioni
obstructive	ostrutivo
obtain	ottenere
obtainable	ottenibile
obtrude	imporre
obtrusion	intrusione
obtrusive	importuno
obtuse	ottuso
obtuseness	ottusita'
obvious	ovvio
obviously	ovviamente
occasion	occasione
occasional	occasionale
occasionally	occasionalmente
occasions	occasioni
occident	occidente
occidental	occidentale
occidentalize	occidentalizzare
occidentalized	occidentalizzato
occidentalizes	occidentalizza
occidentalizing	occidentalizzante
occipital	occipitale
occiput	occipite
occlude	occludere, ostruire
occluded	occluso
occludes	occlude
occlusion	occlusione
occlusions	occlusioni
occult	occulto
occultism	occultismo
occultist	occultista
occupant	occupante
occupants	occupanti
occupation	occupazione
occupational	occupazionale
occupations	occupazioni
occupied	occupato
occupy	occupare
occur	succedere
occurred	successo
occurs	succede
ocean	oceano
oceanarium	oceanario
oceanic	oceanico
oceanographer	oceanografo
oceanographers	oceanografi
oceanographic	oceanografico
oceanography	oceanografia
oceanologic	oceanologico
oceanologist	oceanologista
oceanology	oceanologia
oceans	oceani
o'clock	in punto
octagon	ottagono
octagonal	ottagonale
octane	ottano
octave	ottava
octogenarian	ottuagenario
octopus	polipo, piovra
ocular	oculare
oculist	oculista
oculomotor	oculomotore
odalisque	odalisca
odd	strano
oddball	persona strana, eccentrica
oddballs	persone strane, eccentriche
odder	piu' strano
oddest	il piu' strano
oddities	stranezze
oddity	stranezza
oddly	stranamente
oddment	avanzo
oddness	stranezza
odds	(at odds) in disaccordo
odds	(bets) posta
ode	ode
odious	odioso
odium	odio
odometer	contachilometri
odometers	contachilometri
odontologst	odontologo
odontology	odontologia
odor	odore
odorant	odorante
odoriferous	odoroso, fragrante, profumato
odorless	inodoro
odorous	odoroso
odors	odori
oenology	enologia
o'er	sopra
of	di
off	lontano da
offal	frataglie
offbeat	insolito
offend	offendere
offended	offeso
offends	offende
offense	(mil.) attacco
offense	offesa
offenses	offese
offensive	(mil.)offensiva
offensive	offensivo; sgradevole
offensives	(mil.) offensive
offer	v. offrire
offered	offerta
offering	offerta
offerings	offerte
offers	v. offre
offertory	offertorio
offhand	estemporaneo, improvvisato
offhanded	estemporaneo, improvvisato
offhandedly	estemporaneo, improvvisato
office	ufficio
officeholder	ufficiale, funzionario
officeholders	ufficiali, funzionari
officemate	collega d'ufficio
officer	ufficiale
officers	ufficiali
offices	uffici
official	ufficiale
officialdom	burocrazia
officialese	gergo burocratico
officialism	burocrazia
officially	ufficialmente
officious	ufficioso
officiously	ufficiosamente
officiousness	ufficiosita'
offing	mare al largo
offish	distante, riservato
offishly	in modo distante o riservato
offishness	distante, riservato
offload	scaricare
offscreen	fuori schermo
offset	controbilanciare, compensare
offsets	controbilancia, compensa
offshoot	germoglio
offshore	lontano da terra
offside	fuori gioco
offspring	prole
offstage	fuori scena
oft	spesso, sovente,frequente
often	spesso, sovente,frequente
oftentimes	spesso, sovente, frequente
ofttimes	spesso, sovente, frequente
ogive	ogiva
ogle	n. sguardo amoroso
ogle	v. guardare in modo amoroso
ogled	guardato in modo amoroso
ogler	uno che guarda in modo amoroso
ogles	guarda in modo amoroso
ogre	orco
ogress	orca
oil	olio; petrolio
oilcloth	tela cerata
oiled	oliato
oilskin	tela impermeabilizzata
oily	oleoso
ointment	unguento
ointments	unguenti
old	vecchio
olden	vecchio
older	piu' vecchio
oldest	il piu' vecchio
oldfangled	antiquato
oldster	anziano
oldsters	anziani
oleander	oleandro
oleanders	oleandri
olfactory	olfattivo
oligarch	oligarca
oligarchic	oligarchico
oligarchy	oligarchia
oligopoly	oligopolio
oligosaccharide	oligosaccaride
oligosaccharides	oligosaccaridi
olive	olivo, oliva
olives	olive
olivine	olivina
olympiad	olimpiade
omega	omega
omelet	frittata
omelets	frittate
omen	presagio
omens	presagi
omental	omentale
omentum	omento
one	one
ostrich	struzzo
ostriches	struzzi
pa	papa
pace	passo
paced	avente un certo passo
pacem	chi va al passo, chi fa l'andatura, battistrada, ambasciatore
pacemaker	Stimolatore di battito cardiaco
pacemaking	Facendo Pace
paces	pace
pachyderm	pachiderma
pachydermal	pachiderma
pacifiable	pacificabile
pacific	pacifico
pacifically	pacificamente
pacifications	pacificazioni
pacificator	paciere
pacificators	pacieri
pacificist	pacifista
pacifier	ciuccio
pacifier	ciucciotto
pacifism	pacifismo
pacifist	pacifista
pacify	pacificare
pack	pacco
package	pacchetto
package	pacco
packaged	confezionato
packaged	imballato
packages	pacchetti
packages	pacchi
packaging	imballaggio/imballo
packed	impacchettato/imballato
packet	pacchetto
packetization	pacchettizzazione
packets	pacchetti
packs	pacchi
pact	patto
pacts	patti
pad	imbottitura
padded	Imbottito
paddle	remo
padlock	lucchetto
padre	padre
padrone	padrone
paella	paella, risotto
paestum	paestum
pagan	pagano
paganish	pagano
paganism	paganesimo
paganization	paganizzazione
paganize	paganizzare
paganized	paganizzati
page	pagina
pages	pagine
paginate	impaginare
paginated	impaginato
pagoda	pagoda
pagodas	pagode
paid	pagato
pain	dolore
painful	doloroso
painfully	dolorosamente
painless	indolore
painlessly	senza dolore
painlessness	assenza di dolore
pains	dolori
paint	pittura
paintbrush	pennello
painted	dipinto
painter	pittore
painters	pittori
painting	dipinto
paintings	dipinti
paints	pitture
pair	paio
pairs	pari
palace	palazzo
palaces	palazzi
paladin	paladino
parametric	parametri
patch	toppa
patches	toppe
path	sentiero
patience	pazienza
patient	paziente
patiently	pazientemente
patina	patina
patriarch	patriarca
patriarchal	patriarcale
patriarchate	patriarcato
patrician	patrizio
patricide	patricida
patrimonial	patrimoniale
patrimony	patrimonio
patriot	patriota
patriotic	patriottico
patriotism	patriottismo
patrol	pattuglia
patroller	persona di pattuglia
patron	patrono
patronage	patronaggio
patroness	patrona
people	la gente
pepper	pepe
peppercorn	grano di pepe
peppermint	menta peperita
peppery	pepato, acre, pungente
pepsin	pepsina
permutation	permutazione
permutations	permutazioni
permute	permutare
perorate	perorare
perpendicular	perpendicolare
perpendicularly	perpendicolarmente
perpendiculars	perpendicolari
perpetrate	perpetrare
perpetrated	perpetrato
perpetual	perpetuo
petard	petardo
petroleum	petrolio
physicist	fisico
physics	fisica
play	gioco, partita, commedia
plea	preghiera, domanda,(argomento di) difesa
please	piacere
pleaser	oblativo
plenty	tanto, molto
pliers	pinza
plight	situazione, critica
plod	camminare a stentio, sgobbare
plot	congiura, cospirazione, trama
pollute	inquinare
pollution	inquinamento
polyester	poliestere
poof	froggio
pool	piscina
pools	piscina
poop	cacca
poor	povero
poorer	più povero
poorest	il più povero
poorness	povertà
popcorn	popcorn
pope	papà
poppet	carino
popular	popolare
popularity	popolarità
porcelain	porcelano
pork	maiale
pork	porco
porkies	bugie
porn	pornogrofia
pornographer	pornograficista
pornographic	pornografico
position	posizione
position	posto
possibility	possibilita\
possible	possibile
poster	cartellone
postpone	rimandare
potato	patata
potential	potenziale
potentiometer	potenziometro
potentiometers	potenziometri
potion	pozione
potions	pozioni
practical	pratico/a
praise	lodare
prawn	gamberi
precipitation	precipitazione
precipitator	precipitatore
precise	preciso
precisely	precisamente
precision	precisione
preclinical	preclinico
precocious	precoce
precociously	precocemente
pregnancy	gravidanza
pregnant	gravida
prelature	prelatura
project	progetto
projecting	proiettare
proletarian	proletario
proletarian	proletario
proliferative	prolifero
proliferative	prolifico
prolific	prolifico
provider	fornitore
providers	fornitori
provides	fornisce
providing	fornire, fornendo
providing	che fornisce
province	provincia
provinces	province
provincial	provinciale
provincialism	provincialismo
provitamin	provitamina
provocation	provocazione
pubis	pube
public	pubblico
pudendal	pudendo
pudendum	pudendo
purchasable	acquistabile
purchase	acquisto
purchased	acquistato
purchaser	acquirente
purchasers	acquirenti
purchases	acquisti
purchasing	l'acquistare
pussy	micio
put	mettere
quackery	ciarlataneria
quacks	ciarlatani
quadrangle	quadrangolo
quadrangles	quadrangoli
quadrangular	quadrangolare
quadrant	quadrante
quadrantal	quadrantale
quadrants	quadranti
quadraphonic	quadrafonico
quadraphony	quadrafonia
quadrille	quadriglia
quadriplegic	quadriplegico
quadrivalent	quadrivalente
quadruped	quadrupede
quadruple	quadruplo
quadruplicate	quadruplicare
quadruplicated	quadruplicato
quaff	tracannare
quagmire	pantano
quagmires	pantani
quail	quaglia
quaint	antiquato
quake	tremito; v. tremare
quaked	tremato
quakes	trema
qualification	qualificazione
qualified	qualificato
quarantine	quarantena
quark	quark
quarrel	lite
quarrel	v. litigare
quarrelsome	litigioso
quarry	cava
quarter	quarto
quarterage	pagamento trimestrale
quarterdeck	cassero
quarterdecks	casseri
quarterly	trimestrale
quartet	quartetto
quartets	quartetti
quartz	quarzo
quartzite	quarzite
quasar	quasar
quash	v. schiacciare
quashed	schiacciato
quaternary	quaternario
quaver	v. tremare
quavery	tremolante
quay	molo
quean	prostituta
queasy	nauseabondo
queen	regina
queens	regine
queer	omosessuale
queer	strano
queerer	piu' strano
quell	v. reprimere
quench	estinguere, spegnere
quern	macinino
query	domanda
query	v. chiedere
quest	ricerca
question	domanda
question	questione
questionnaire	questionario
queue	fila, coda
quibble	cavillo
quibble	v. cavillare
quick	rapido, svelto
quicklime	calce viva
quickly	rapidamente
quickness	rapidita', prontezza
quicksand	sabbia mobile
quickset	di piante vive
quicksilver	mercurio
quid	sterlina
quiescent	quiescente
quiet	quieto, silenzioso
quiet	v. aquietare, calmare
quill	penna d'oca (per scrivere)
quilt	trapunta
quilt	v. trapuntare
quince	mela cotogna
quinine	chinino
quintessence	quintessenza
quintet	quintetto
quintets	quintetti
quintuplicate	quintuplicare
quip	battuta arguta
quire	misura di carta (24 fogli)
quirk	stranezza
quirks	stranezze
quirt	frustino
quisling	collaborazionista
quit	v. lasciare, smettere
quitclaim	rinuncia
quiver	faretra
quiz	quiz
quod	prigione
quorum	quorum
quota	quota
quotas	quote
quotation	citazione
quotation	quotazione
quotations	citazioni
quotations	quotazioni
quote	citazione
quote	v. citare
quote	v. quotare
quoted	citato
quotes	citazioni
quotidian	quotidiano
quotient	quoziente
quotients	quozienti
r	r
rabbet	scanalatura
rabbeting	scanalando - unendo ad incastro
rabbi	rabbino
rabbinate	rabbinato
rabbinic	rabbinico
rabbinical	rabbinico
rabbinically	rabbinicamente
rabbinism	rabbinismo
rabbit	coniglio
rabbitry	allevamento di conigli
rabbits	conigli
rabbity	di coniglio - pieno di conigli
rabble	folla
rabbled	agitato - rimescolato
rabblement	accozzaglia, massa
rabid	rabbioso
rabidity	furia
rabidly	rabbiosamente
rabies	rabbia
raccoon	procione lavatore
raccoons	procioni - orsi lavatori
race	corsa
racecourse	ippodromo
racehorse	corsa di cavalli
racehorses	cavalli da corsa
racemic	racemico
racemization	racemizzazione
racemize	racemizzare
racer	corridore
racers	corridori
races	corse
racetrack	ippodromo
rachides	rachide
rachis	rachide
rachitic	rachitico
rachitis	rachitismo
racial	razziale
racialism	razzismo
racialist	razzista
racialistic	razzistico - razzialista
racially	razzialmente
racism	razzismo
racist	razzista
racists	razzisti
rack	rastrelliera - scaffale - cremagliera
racket	chiasso - organizzazione criminale - 
racketeer	truffatore - ricattatore
racketeering	truffe - ricatti - estorsioni di denaro
racketeers	truffatori - ricattatori
rackety	chiassoso - festaiolo
raconteur	raccontatore
racoon	procione - orso lavatore
racy	genuino - salace - di sapore caratteristico
rad	radicale (abbr)
radar	radar
radars	radar (pl)
raddle	tingere con ocra rossa - imbellettare
radial	radiale
release	rilasciare
renewal	rinnovo
renewed	rinnovato
renewer	rinnovatore
report	relazione
reported	riferito
reports	relazioni
repositioned	spostato
repost	reindirizzare
represent	rappresentare
return	ritornare
riot	sommossa, tumulto
riotous	tumultuoso, sfrenato, scatenato
road	Road
road	strada
roadbed	massicciata
roads	strade
roadstead	ormeggio
roadway	carreggiata
roadways	carreggiate
roar	ruggire
rob	rubare
robber	ladro
robberies	furti
robbers	ladri
robbery	furto
robust	robusto
room	stanza
roomy	a spazioso
run	correre
sabbat	saturday/sabato
sabbath	sabba
sabbatic	sabbatico
sabbatical	sabbatico
saber	sciabola
saberlike	simile ad una sciabola
sabertooth	dai denti a sciabola
sable	baio
sables	sabbie
sabot	borra
sabotage	sabotaggio
sabotaged	sabotato
sabotages	sabotaggi
sabotaging	sabotaggio
saboteur	sabotatore
saccharide	saccaride
saccharides	saccaridi
saccharification	saccarificazione
saccharify	saccarificare
saccharimeter	saccarimetro
saccharimeters	saccarimetri
saccharimetry	saccarimetria
saccharin	saccarina
saccharine	saccarina
saccharometer	saccarometro
saccharometers	saccarometri
saccharomyces	saccaromiceti
saccharose	saccarosio
sacerdotal	sacerdotale
sacks	sacchi
sacral	sacrale
sacrament	sacramento
sacramental	sacramentale
sacramentalism	sacramentalismo
sacramentalist	sacramentalista
sacraments	sacramenti
sacrarium	sacrario
sacred	sacro
sacrestia	sacrestia
sacrifice	sacrificio
sacrificed	sacrificato
sacrificers	sacrificatori
sacrifices	sacrifici
sacrificing	sacrificando
sacrilege	sacrilego
sacrilegious	sacrilego
sacristan	sacrestano
sacristy	sacrestia
sacroiliac	sacroiliaco
sacrosanct	sacrosanto
sad	triste
saddle	sella
saddler	sellaio
saddles	selle
sadism	sadismo
sadist	sadista
sadistic	sadistico
sadists	sadisti
sadly	tristemente
sadness	tristezza
sadomasochism	sadomasochismo
sadomasochist	sadomasochista
sadomasochistic	sadomasochistico
safari	safari
safe	sicuro
safeguard	salvaguardia
safeguarded	salvaguardato
safeguards	protezioni, salvaguardie
safer	più sicuro
safest	il più sicuro
safety	sicurezza
saffron	zafferano
saga	saga
sagacious	sagace
sagacity	sagacia
sage	saggina
sagebrush	scopa di saggina
sail	navigare (a vela)
sailboat	veliero
sailboater	velista
sailboats	barche a vela
sailer	navigatore (a vela)
sailor	marinaio
sailors	marinai
saint	santo
saintdom	santita'
saints	santi
salad	insalata
salads	insalate
salamander	salamandra
sale	vendere
saleable	vendibile
salesclerk	commesso
salesgirl	commessa
saleslady	commessa
salesman	commesso
salesmen	commessi
salespeople	commessi
salesperson	commessi
saleswoman	commessa
saleswomen	commessa
salinity	salinita'
salinize	salinizzare
saliva	saliva
salivation	salivazione
salmon	salmone
salmonella	salmonella
salmonellosis	salmonellosi
salmons	salmoni
salt	sale
sand	sabbia
satisfied	sodisfatto
sauce	salsa
scallion	scalogno
scallop	conchiglia
scalloped	dentellato
scallopini	scallopini
scallops	conchiglie
scalpel	scapello
scalper	bagarino
scaly	squamoso
scamp	briccone
scamper	sgambettare
scampered	sgambettato
scampering	sgambettando
scampers	sgambetta
scampi	scampi (shrimp)
scampini	scampini (small shrimp)
scan	scrutare
scandal	scandalo
scandalize	scandalizzare
scandalized	scandalizzato
scandalizes	scandalizza
scandalous	scandaloso
scandalously	scandalosamente
scandals	scandoli
scannable	scrutabile
scanned	scrutato
scanner	scrutore
scanners	scrutori
scanning	scruta
scattering	dispersione
scattering	diffusione
school	school
screed	massetto
screen	coprire
screen	riparare
screen	schermo
screen	schermo
screw	vite
screwed	avvitato
screwer	cacciavite
scrimp	scampo
sculptor	scultore
sea	mare
section	sezione
seduce	sedurre
seduced	sedotto
seducer	seduttore
seduction	seduzione
seductive	seduttivo
see	vedere
seed	seme
send	spedire
sender	chi spedisce
sensation	sensazione
settings	impostazioni
seven	sette
seventeen	diciassette
seventeenth	diciassettesimo
seventh	settimo
seventies	anni settanta
sex	sesso
sexist	sessista
sexual	sessuali
sexuality	sessuality
sexually	sessualamente
shabbiness	transandatezza
shabby	scialbo
shack	catapecchia
sheep	pecora
sheepish	timido
sheer	chiaro
sheer	puro
sheet	foglio
sheet	lenzuolo
shelf	scaffale
shellfish	crostaceo
shelter	ricovero
shift	cambio
shilling	scellino
shine	brillare [something shines]
shine	pulire [shine something]
ship	nave (f)
shipping	spedizione
ships	navi
shipshape	in perfetto ordine
shipwreck	relitto, naufragio
shipyard	cantiere navale
shire	contea (british)
shirk	evitare, sottrarsi a
shirt	camicia
shirts	camicie
shit	merda
shiver	brivido, rabbrividire, tremare
shock	colpo, urto
shockproof	a prova di urto
shoe	scarpa
shoelace	stringa
shoes	scarpe
shoot	sparare
shoot	sparo
shop	negozio
shot	foto (phot)
shot	sparo
shot	tiro (football)
shower	acquazzone,pioggia (di sassi ad es.), doccia
showing	proiezione (di un film)
shrug	scrollata di spalle
shrunk	ristretto,ridotto
shudder	brivido
shuffle	mescolare
shun	evitare
shunt	deviare, smistare, spostare
shunted	deviato
shut	chiudere
shutdowns	chiudere definitivamente
skull	cranio
slave	schiavo
slavery	schiavitu
slaves	schiavi
smuggle	contrabbandare
smuggled	di contrabbando, contrabbandato
smuggler	contrabbandiere
smuggling	contrabbando
smutty	osceno, indecente
snack	spuntino
snag	intoppo, ostacolo imprevisto
snail	chiocciola
snaillike	a chiocciola (ad es.: scala a chiocciola)
snake	serpente
snap	schianto,colpo secco, (fotografia):istantanea
soap	sapone
soldier	soldato
son	figlio
song	canzone
speak	parlare
special	speciale
specialist	specialista
specialistic	specialistico
specialists	specialisti
specialization	specializzazione
specialize	specializzare
specialized	Specializzato
specializer	specializzatore
specializers	specializzatori
specializing	specializzando
specially	specialmente
specials	speciali
specialties	specialità
specialty	specialità
specifically	specificatamente
specification	specificazione
specifications	specificazioni
spine	spina dorsale
splenectomy	splenectomia
splenomegaly	splenomegalia
sprawl	stravaccarsi, sdraiarsi scompostamente
sprawled	stravaccato
sprawling	che si stravacca
spray	spruzzare
spread	spargere, diffondere, distribuire
spring	saltare,primavera (noun)
star	stella
straw	paglia
strawberries	fragole
strawberry	fragola
stream	ruscello
streaming	che scorre
street	strada
streets	strade
strength	forza
strengthen	rinforzare, rafforzare
strengthened	rinforzato
strenuous	strenuo
strenuously	strenuamente
streptococcus	streptococco
streptokinase	streptochinasi
streptolysin	streptolisina
streptomycin	streptomicina
stress	tensione
stressed	teso
structure	struttura
sugar	zucchero
sun	sole
sunbathe	prendere il sole
sunbeam	raggio di sole
sunglasses	occhiali da sole
sunlight	luce del sole
sunrise	alba
surgery	chirurgia
surgical	chirurgico
surgically	chirurgicamente
swamp	palude
sweet	dolce
sweetbread	animella
sweeten	inzuccherare
sweetheart	carino(masc); carina(fem)
sweetness	dolcezza; fragranza(as in smell)
swell	gonfiarsi(verb); onda di fondo(noun - as a swell in the sea)
swelling	gonfiezza
swerve	deviare; slittare(as in skid)
swift	presto; veloce
swiftly	velocemente
swig	sorsata
swill	risciacquare
swim	nuotare
swimsuit	costume da bagno
swindle	truffa
swindler	scroccone
swine	porco
swing	altalena, oscillazione, ritmo,oscillare, dondolare
swingeing	violento, enorme
swipe	colpire con forza, schiaffeggiare; sgraffignare
swirl	turbinare
switch	frustino(riding switch); interruttore(electrical switch)
swivel	perno
swoon	svenire
swoop	piombare dall'alto(swoop down)
sword	spada
sworn	giurato
syllable	sillaba
syllabus	compendio
symbol	simbalo
system	sistema
systematically	sistematicamente
systolic	sistolico
tab	etichetta
tab	tabulazione
tabac	tabacco
tabernacle	tabernacolo
tabernacles	tabernacoli
tablature	tavolatura
table	tavola
table	tavolo
tablecloth	tovaglia
tablecloths	tovaglie
tables	tavoli
tablespoon	cucchiaio da tavola
tablespoonful	cucchiaiata
tablespoons	cucchiai da tavola
tablespoonsful	cucchiaiate
tabloid	giornale popolare
taboo	tabú
taboo	vietato
taboos	tabu\
tabor	tamburello
tabu	tabu\
tabula	tabula
tabular	tabulare
tabulator	tabulatore
tabulators	tabulatori
tachycardia	tachicardia
tachymeter	tachimetro
tacit	tacito
taciturn	taciturna
taciturn	taciturno
take	prendere
takeoff	atterrare
tale	racconto, favola
talk	conversare, parlare
talkative	loquace
tall	alto
tap	(n) spina (in a keg); rubinetto (faucet); presa (elect.); (v) battere, picchiare; spillare (from a barrel); intercettare (a phone); tip tap (to tapdance)
tape	(n)nastro; stricione del traguardo (in sports); (v) legare con nastro
taped	legato con nastro
taper	(n)cerino; (v) [trans.] affusolare; [intrans.] affusolarsi
tapered	affusolato
tapering	affusolante
tapers	cerini
tapes	nastre
tapestried	tapezzato
tapestries	tappezzerie
tapestry	tappezzeria
tapeworm	tenia, verme solitario
taping	legando con nastro
tapioca	tapioca
tapir	formichie\re
tapirs	formichie\ri
tapped	battutto
tapper	battitore
tappers	battitori
tappet	(aut) punteria
taproom	taverna, osteria
taproot	radice a fittone
taproots	radici a fittone
taps	rubinetti; prese; spine
tar	(n) catrame; (v) incatramare
tarantula	tarantula
tarantulas	tarantule
tardier	piu\ lento, in ritardo
target_language	Italian
target_language	Italian[]
tea	te\
teacher	insegnante
teachers	insegnanti
teaching	insegnamento
team	squadra, gruppo
teammate	compagno di squadra
teammates	compagni di squadra
teams	squadre
teapot	teiera
tearoom	sala da the\
tears	lacrime
teaspoon	cucchiaino
technetium	tecnezio
technical	tecnico
telephone	tele\fono
telephonic	telefo\nico
telephony	telefonia
template	sagoma
tensor	tensore
tensorial	tensoriale
tensors	tensori
tent	tenda
tentacle	tentacolo
tentacles	tentacoli
tentacular	tentacolare
tenth	decimo
tenths	decimi
tepee	tepee
tepees	tepee
tequila	tequila
than	che
thank	gratzie
thank	you
thanks	grazie
that	quello
tide	marea
tie	cravatta
tomorrow	domani
trade	commercio
trademark	marchio di fabbrica
tradeoff	compromesso
tradesman	commerciante
traditional	tradizionale
travel	viaggio
trowel	frattazzo
troweled	fratazzato
troweled	fratazzato
true	justo
true	vero
trumpet	tromba
ulcer	ulcera
ulna	ulna
ulnar	ulnare
uncle	lo zio (gli zii)
uncommon	poco comune
uncompleted	incompiuto
uncompleted	incompleto
uncompromising	intrattbile
unconcern	noncuranza
unconcerned	noncurante, indifferente
unconditional	senza riserva, senza condizioni
untrans	n
untrans	n[]
update	aggiornare
upgrade	promuovere
uphill	salita
vacancy	posto vacante - ozio - vuoto
vacant	vuoto - libero - vacuo - distratto
vacantly	vacuamente - con aria assente
vacate	liberare - evacuare - dimettersi
vacated	Evacuato
vacation	sgombero - dimissione - rinuncia - vacanza
vacationer	villeggiante - vacanziere
vacationers	villeggianti - vacanzieri (pl)
vacationland	zona di villeggiatura
vacations	vacanze - ferie
vaccinal	vaccinico
vaccinate	vaccinare
vaccinated	Vaccinato
vaccinating	Vaccinando
vaccination	vaccinazione
vaccinations	vaccinazioni (pl)
vaccinator	vaccinatore - vaccinostilo
vaccinators	vaccinatori - vaccinostili
vaccine	vaccino - siero
vaccines	Vaccini
vacillate	vacillare - barcollare
vacillation	vacillamento - barcollamento - esitazione
vacuity	vuoto - lacuna - vacuita\ - stupidita\
vacuolar	vacuolare
vacuole	vacuolo
vacuous	vuoto - vacuo - insignificante
vacuousness	vuoto - lacuna - vacuita\
vacuum	vuoto - aspirapolvere
vacuums	vuoti
vagabond	vagabondo - nomade - girovago
vagabondage	vagabondaggio
vagabondish	da vagabondo
vagabondism	Vacabondismo
vagabonds	Vagabondi
vagaries	capricci - stravaganze
vagary	capriccio - stravaganza
vagina	vagina
vaginal	vaginale
vaginally	vaginalmente
vaginas	vagine
vagrancy	vagabondaggio - accattonaggio
vagrant	vagabondo - ambulante - randagio - nomade 
vague	vago - incerto - indistinto - indeterminato - impreciso
vaguely	vagamente - indeterminatamente
vagueness	vaghezza - incertezza - indeterminazione
vaguer	piu\ vago
vaguest	vaghissimo
validation	Validato
valley	Valle
vector	vettore
vectorial	vettoriale
vectors	vettori
vegetarian	vegetariano
vegetarians	vegetariani
vehicle	veicolo
vehicles	veicoli
venire	venire
victory	vittoria
victual	vitto
vide	vuoto
video	video
view	vista
viewed	visto
viewer	spettatore
viewing	vedendo?
viewpoint	punto di vista
vigil	vigile
vigilance	vigilanza
vigilant	vigilante
vigilantes	vigilanti
wacky	pazzo
wad	batuffolo
waddle	sculettare
waddled	sculetto
wade	guadare
wads	batuffoli
wafer	cialda
wafers	cialde
waffle	cialda
waffles	cialde
waft	spandersi
wag	scodinzolare
wage	solario
wager	scommessa
wagerer	giocatore
waggish	scherzoso
wagon	vagone
wagons	carri
waif	trovatello
wail	gemere
wain	carriaggio
waist	vita
waistband	cintola
waistcoat	corpetto
waistcoats	corpetti
wait	aspettare
waitress	cameriera
waitresses	cameriere
waive	onda
waiver	rinuncia
wake	veglia
wakeful	sveglio
waken	svegliare
walk	camminare
walk	cammino(noun)
walked	(who walked?)
walkingstick	bastone
wall	muro
wallaby	canguro
wallaroo	canguro
wallet	portafoglio
wallflower	violacciocca
wallow	sguazzare
wallpaper	tappezzeria
walnut	noce
walnuts	noci
walrus	tricheco
walruses	tricheco
waltz	valzer
wan	smunto
wand	bacchetta
wander	vagare
wanderer	pellegrino
wanderers	pellegrini
wane	declinare
want	volere
wanton	licenzioso
war	guerra
warble	gorgheggio
ward	distretto
warden	guardiano
wardens	guardiani
wardrobe	quardaroba
wardrobes	quardarobe
wardroom	guadrato
wardrooms	guadrati
wards	distretti
warhead	testata
warp	italian
washable	lavabile
watch	Airhog II vs. weljer
watch	orologio
watch	sentinella
watch	guardare
watch	sorvegliare
water	acqua
watercolor	acquerello
waterfall	cascata
waterfront	lungomare
watermelon	anguria
waterproof	impermeabile
wave	onda
wavelength	lunghezza d'onda
wavelengths	lunghezze d'onda
weak	debole
web	ragnatela
wed	sposata/sposato
wedding	matrimonio/sposalizio
week	settimana
weekday	feriale
weekday	giorno lavorativo ( n.+adj.)
weekdays	gioni lavorativi
weekend	festiva
weekend	fine settimana
weekly	settimanale
weep	piangere
weight	peso
welcome	benvenuto
wet	bagnato
whale	balena
what	che
whatever	qualunque
whatsoever	qualsiasi cosa
wheat	frumento
wheel	ruota
wheelbarrow	carriola
when	quando
where	dove
while	mentre
white	bianco
why	perche/[Pronoun]
wick	stoppino
wicked	malvagio
wickedly	con malvagita\
wicket	cancelletto
wide	largo
widely	largamente
widen	allargare
widening	allargamento
widespread	diffuso
widget	gingillo
widow	vedova
widower	vedovo
width	larghezza
widthwise	in larghezza
wield	esercitare
wife	moglie
wig	parrucca
wild	selvaggio
win	vincere
wind	vento
window	finestra
windshield	parabrezza
wine	vino
wish	auguri
with	con[Preposition]
with	col, colla, coi, etc ["with the"]
without	senza[Preposition]
wizard	mago
wizard	portentoso
wizard	stregone
woman	donna
womanish	femminile
women	donne
work	lavorare
wrap	Incapsulare
wrapping	Incapsulamento
x	x - dieci (10 in numeri romani)
xenophobe	xenofobo
xenophobia	xenofobia
xenophobic	xenofobico
xi	undici (11 in numeri romani)
xii	dodici (12 in numeri romani)
xiii	tredici (13 in numeri romani)
xiv	quattordici (14 in numeri romani)
xix	diciannove (19 in numeri romani)
xor	Or esclusivo (Xor)
xv	quindici (15 in numeri romani)
xvi	sedici (16 in numeri romani)
xvii	diciassette (17 in numeri romani)
xviii	diciotto (18 in numeri romani)
xx	venti (20 in numeri romani)
xylophone	xilofono
xylophones	xilofoni
yacht	panfilo
yachting	fare una crocera su un panfilo
yachts	panfili
yachtsman	proprietario di panfili
yachtsmen	proprietari di panfili
yak	yak
yaks	yak
yap	guaire
yapping	guaendo
yard	iarda
yards	iarde
yawn	sbadiglio
yawning	sbadigliando
year	anno
yearly	annualmente
yellow	giallo
your	il tuo, la tua, i tuoi, le tue 
yours	il tuo, la tua
yourself	ti
youth	gioventu
zabaglione	zabaglione
zabaglione	zabaglione
zanies	buffoni - comici
zanily	buffonescamente
zany	buffone
zap	eliminare - uccidere - sfrecciare
zeal	zelo
zealot	zelota - presona zelante
zealotry	zelo eccessivo - fanatismo
zealous	zelante
zealously	promurosamente - fanaticamente
zealousness	zelo - premura - sollecitudine
zebra	zebra
zebra	zebra
zebras	zebre
zeitgeist	spirito del tempo
zenith	zenit
zenithal	zenitale
zeolite	zeolite
zephyr	zefiro
zephyr	zaffiro
zeppelin	Zeppelin
zero	zero
zero	zero
zeroed	azzerato
zeroes	zeri
zeroing	azzeramento
zeros	zeri
zest	aroma - gusto - sapore piccante
zestful	saporito - piccante - aromatico
zeta	zeta
zigzag	zigzagare
zinc	zinco
zinfandel	chiaretto
zipper	cerniera lampo
zircon	zircone
zither	cetra tirolese
zodiac	zodiaco
zodiacal	zodiacale
zone	zona
zonked	incosciente
zoo	zoo
zoologic	zoologico
zoological	zoologico
zoologist	zoologo
zoologists	zoologi
zoology	zoologia
zoom	zumare
zoomorphic	zoomorfo
zoophyte	zoofito
zoos	giardini zoologichi